base_year,base_month,city,emd_cd,emd_nm,sex,resid_reg_pop,foreign_pop,total_pop,base_year_month
2018,1,제주시,50110590,건입동,남성+여성,9800,228,10028,2018년 1월
2018,2,제주시,50110590,건입동,남성+여성,9814,224,10038,2018년 2월
2018,3,제주시,50110590,건입동,남성+여성,9783,222,10005,2018년 3월
2018,4,제주시,50110590,건입동,남성+여성,9788,229,10017,2018년 4월
2018,5,제주시,50110590,건입동,남성+여성,9800,238,10038,2018년 5월
2018,6,제주시,50110590,건입동,남성+여성,9782,249,10031,2018년 6월
2018,7,제주시,50110590,건입동,남성+여성,9775,258,10033,2018년 7월
2018,8,제주시,50110590,건입동,남성+여성,9756,264,10020,2018년 8월
2018,9,제주시,50110590,건입동,남성+여성,9729,263,9992,2018년 9월
2018,10,제주시,50110590,건입동,남성+여성,9702,251,9953,2018년 10월
2018,11,제주시,50110590,건입동,남성+여성,9658,248,9906,2018년 11월
2018,12,제주시,50110590,건입동,남성+여성,9610,247,9857,2018년 12월
2019,1,제주시,50110590,건입동,남성+여성,9506,254,9760,2019년 1월
2019,2,제주시,50110590,건입동,남성+여성,9457,256,9713,2019년 2월
2019,3,제주시,50110590,건입동,남성+여성,9456,255,9711,2019년 3월
2019,4,제주시,50110590,건입동,남성+여성,9463,254,9717,2019년 4월
2019,5,제주시,50110590,건입동,남성+여성,9419,254,9673,2019년 5월
2019,6,제주시,50110590,건입동,남성+여성,9417,259,9676,2019년 6월
2019,7,제주시,50110590,건입동,남성+여성,9408,260,9668,2019년 7월
2019,8,제주시,50110590,건입동,남성+여성,9380,260,9640,2019년 8월
2019,9,제주시,50110590,건입동,남성+여성,9380,263,9643,2019년 9월
2019,10,제주시,50110590,건입동,남성+여성,9359,261,9620,2019년 10월
2019,11,제주시,50110590,건입동,남성+여성,9335,252,9587,2019년 11월
2019,12,제주시,50110590,건입동,남성+여성,9311,260,9571,2019년 12월
2020,1,제주시,50110590,건입동,남성+여성,9230,266,9496,2020년 1월
2020,2,제주시,50110590,건입동,남성+여성,9209,273,9482,2020년 2월
2020,3,제주시,50110590,건입동,남성+여성,9202,263,9465,2020년 3월
2020,4,제주시,50110590,건입동,남성+여성,9170,250,9420,2020년 4월
2020,5,제주시,50110590,건입동,남성+여성,9164,245,9409,2020년 5월
2020,6,제주시,50110590,건입동,남성+여성,9150,246,9396,2020년 6월
2020,7,제주시,50110590,건입동,남성+여성,9136,244,9380,2020년 7월
2020,8,제주시,50110590,건입동,남성+여성,9116,240,9356,2020년 8월
2020,9,제주시,50110590,건입동,남성+여성,9101,235,9336,2020년 9월
2020,10,제주시,50110590,건입동,남성+여성,9110,239,9349,2020년 10월
2020,11,제주시,50110590,건입동,남성+여성,9101,236,9337,2020년 11월
2020,12,제주시,50110590,건입동,남성+여성,9091,234,9325,2020년 12월
2021,1,제주시,50110590,건입동,남성+여성,9042,237,9279,2021년 1월
2021,2,제주시,50110590,건입동,남성+여성,8984,231,9215,2021년 2월
2021,3,제주시,50110590,건입동,남성+여성,8917,231,9148,2021년 3월
2021,4,제주시,50110590,건입동,남성+여성,8922,226,9148,2021년 4월
2021,5,제주시,50110590,건입동,남성+여성,8900,227,9127,2021년 5월
2021,6,제주시,50110590,건입동,남성+여성,8883,227,9110,2021년 6월
2018,1,제주시,50110256,구좌읍,남성+여성,15574,552,16126,2018년 1월
2018,2,제주시,50110256,구좌읍,남성+여성,15610,553,16163,2018년 2월
2018,3,제주시,50110256,구좌읍,남성+여성,15596,552,16148,2018년 3월
2018,4,제주시,50110256,구좌읍,남성+여성,15608,550,16158,2018년 4월
2018,5,제주시,50110256,구좌읍,남성+여성,15645,559,16204,2018년 5월
2018,6,제주시,50110256,구좌읍,남성+여성,15672,589,16261,2018년 6월
2018,7,제주시,50110256,구좌읍,남성+여성,15715,601,16316,2018년 7월
2018,8,제주시,50110256,구좌읍,남성+여성,15677,608,16285,2018년 8월
2018,9,제주시,50110256,구좌읍,남성+여성,15685,611,16296,2018년 9월
2018,10,제주시,50110256,구좌읍,남성+여성,15669,617,16286,2018년 10월
2018,11,제주시,50110256,구좌읍,남성+여성,15654,620,16274,2018년 11월
2018,12,제주시,50110256,구좌읍,남성+여성,15670,613,16283,2018년 12월
2019,1,제주시,50110256,구좌읍,남성+여성,15574,610,16184,2019년 1월
2019,2,제주시,50110256,구좌읍,남성+여성,15633,606,16239,2019년 2월
2019,3,제주시,50110256,구좌읍,남성+여성,15601,624,16225,2019년 3월
2019,4,제주시,50110256,구좌읍,남성+여성,15627,662,16289,2019년 4월
2019,5,제주시,50110256,구좌읍,남성+여성,15641,665,16306,2019년 5월
2019,6,제주시,50110256,구좌읍,남성+여성,15650,661,16311,2019년 6월
2019,7,제주시,50110256,구좌읍,남성+여성,15642,669,16311,2019년 7월
2019,8,제주시,50110256,구좌읍,남성+여성,15661,670,16331,2019년 8월
2019,9,제주시,50110256,구좌읍,남성+여성,15651,672,16323,2019년 9월
2019,10,제주시,50110256,구좌읍,남성+여성,15605,669,16274,2019년 10월
2019,11,제주시,50110256,구좌읍,남성+여성,15556,658,16214,2019년 11월
2019,12,제주시,50110256,구좌읍,남성+여성,15589,643,16232,2019년 12월
2020,1,제주시,50110256,구좌읍,남성+여성,15549,654,16203,2020년 1월
2020,2,제주시,50110256,구좌읍,남성+여성,15554,648,16202,2020년 2월
2020,3,제주시,50110256,구좌읍,남성+여성,15514,625,16139,2020년 3월
2020,4,제주시,50110256,구좌읍,남성+여성,15433,618,16051,2020년 4월
2020,5,제주시,50110256,구좌읍,남성+여성,15452,614,16066,2020년 5월
2020,6,제주시,50110256,구좌읍,남성+여성,15466,611,16077,2020년 6월
2020,7,제주시,50110256,구좌읍,남성+여성,15499,602,16101,2020년 7월
2020,8,제주시,50110256,구좌읍,남성+여성,15524,594,16118,2020년 8월
2020,9,제주시,50110256,구좌읍,남성+여성,15531,597,16128,2020년 9월
2020,10,제주시,50110256,구좌읍,남성+여성,15546,595,16141,2020년 10월
2020,11,제주시,50110256,구좌읍,남성+여성,15557,596,16153,2020년 11월
2020,12,제주시,50110256,구좌읍,남성+여성,15546,583,16129,2020년 12월
2021,1,제주시,50110256,구좌읍,남성+여성,15512,587,16099,2021년 1월
2021,2,제주시,50110256,구좌읍,남성+여성,15530,583,16113,2021년 2월
2021,3,제주시,50110256,구좌읍,남성+여성,15412,573,15985,2021년 3월
2021,4,제주시,50110256,구좌읍,남성+여성,15425,566,15991,2021년 4월
2021,5,제주시,50110256,구좌읍,남성+여성,15402,561,15963,2021년 5월
2021,6,제주시,50110256,구좌읍,남성+여성,15401,554,15955,2021년 6월
2018,1,서귀포시,50130253,남원읍,남성+여성,19112,628,19740,2018년 1월
2018,2,서귀포시,50130253,남원읍,남성+여성,19142,635,19777,2018년 2월
2018,3,서귀포시,50130253,남원읍,남성+여성,19178,628,19806,2018년 3월
2018,4,서귀포시,50130253,남원읍,남성+여성,19203,633,19836,2018년 4월
2018,5,서귀포시,50130253,남원읍,남성+여성,19252,638,19890,2018년 5월
2018,6,서귀포시,50130253,남원읍,남성+여성,19250,680,19930,2018년 6월
2018,7,서귀포시,50130253,남원읍,남성+여성,19190,700,19890,2018년 7월
2018,8,서귀포시,50130253,남원읍,남성+여성,19173,704,19877,2018년 8월
2018,9,서귀포시,50130253,남원읍,남성+여성,19150,724,19874,2018년 9월
2018,10,서귀포시,50130253,남원읍,남성+여성,19099,732,19831,2018년 10월
2018,11,서귀포시,50130253,남원읍,남성+여성,19094,728,19822,2018년 11월
2018,12,서귀포시,50130253,남원읍,남성+여성,19038,740,19778,2018년 12월
2019,1,서귀포시,50130253,남원읍,남성+여성,19032,761,19793,2019년 1월
2019,2,서귀포시,50130253,남원읍,남성+여성,19020,762,19782,2019년 2월
2019,3,서귀포시,50130253,남원읍,남성+여성,19035,762,19797,2019년 3월
2019,4,서귀포시,50130253,남원읍,남성+여성,19086,770,19856,2019년 4월
2019,5,서귀포시,50130253,남원읍,남성+여성,19126,770,19896,2019년 5월
2019,6,서귀포시,50130253,남원읍,남성+여성,19125,790,19915,2019년 6월
2019,7,서귀포시,50130253,남원읍,남성+여성,19098,800,19898,2019년 7월
2019,8,서귀포시,50130253,남원읍,남성+여성,19109,799,19908,2019년 8월
2019,9,서귀포시,50130253,남원읍,남성+여성,19049,811,19860,2019년 9월
2019,10,서귀포시,50130253,남원읍,남성+여성,18990,811,19801,2019년 10월
2019,11,서귀포시,50130253,남원읍,남성+여성,18936,815,19751,2019년 11월
2019,12,서귀포시,50130253,남원읍,남성+여성,18905,802,19707,2019년 12월
2020,1,서귀포시,50130253,남원읍,남성+여성,18864,798,19662,2020년 1월
2020,2,서귀포시,50130253,남원읍,남성+여성,18854,798,19652,2020년 2월
2020,3,서귀포시,50130253,남원읍,남성+여성,18824,791,19615,2020년 3월
2020,4,서귀포시,50130253,남원읍,남성+여성,18813,771,19584,2020년 4월
2020,5,서귀포시,50130253,남원읍,남성+여성,18758,757,19515,2020년 5월
2020,6,서귀포시,50130253,남원읍,남성+여성,18754,752,19506,2020년 6월
2020,7,서귀포시,50130253,남원읍,남성+여성,18762,743,19505,2020년 7월
2020,8,서귀포시,50130253,남원읍,남성+여성,18752,737,19489,2020년 8월
2020,9,서귀포시,50130253,남원읍,남성+여성,18734,729,19463,2020년 9월
2020,10,서귀포시,50130253,남원읍,남성+여성,18744,715,19459,2020년 10월
2020,11,서귀포시,50130253,남원읍,남성+여성,18757,715,19472,2020년 11월
2020,12,서귀포시,50130253,남원읍,남성+여성,18766,703,19469,2020년 12월
2021,1,서귀포시,50130253,남원읍,남성+여성,18756,696,19452,2021년 1월
2021,2,서귀포시,50130253,남원읍,남성+여성,18751,686,19437,2021년 2월
2021,3,서귀포시,50130253,남원읍,남성+여성,18704,680,19384,2021년 3월
2021,4,서귀포시,50130253,남원읍,남성+여성,18729,661,19390,2021년 4월
2021,5,서귀포시,50130253,남원읍,남성+여성,18702,654,19356,2021년 5월
2021,6,서귀포시,50130253,남원읍,남성+여성,18717,637,19354,2021년 6월
2018,1,제주시,50110660,노형동,남성+여성,53369,1589,54958,2018년 1월
2018,2,제주시,50110660,노형동,남성+여성,53369,1664,55033,2018년 2월
2018,3,제주시,50110660,노형동,남성+여성,53317,1683,55000,2018년 3월
2018,4,제주시,50110660,노형동,남성+여성,53368,1770,55138,2018년 4월
2018,5,제주시,50110660,노형동,남성+여성,53472,1973,55445,2018년 5월
2018,6,제주시,50110660,노형동,남성+여성,53568,2012,55580,2018년 6월
2018,7,제주시,50110660,노형동,남성+여성,53580,2038,55618,2018년 7월
2018,8,제주시,50110660,노형동,남성+여성,53655,2040,55695,2018년 8월
2018,9,제주시,50110660,노형동,남성+여성,53719,2040,55759,2018년 9월
2018,10,제주시,50110660,노형동,남성+여성,53835,2173,56008,2018년 10월
2018,11,제주시,50110660,노형동,남성+여성,53902,2197,56099,2018년 11월
2018,12,제주시,50110660,노형동,남성+여성,54002,2221,56223,2018년 12월
2019,1,제주시,50110660,노형동,남성+여성,53961,2252,56213,2019년 1월
2019,2,제주시,50110660,노형동,남성+여성,53859,2247,56106,2019년 2월
2019,3,제주시,50110660,노형동,남성+여성,53818,2287,56105,2019년 3월
2019,4,제주시,50110660,노형동,남성+여성,53772,2504,56276,2019년 4월
2019,5,제주시,50110660,노형동,남성+여성,53805,2514,56319,2019년 5월
2019,6,제주시,50110660,노형동,남성+여성,53800,2510,56310,2019년 6월
2019,7,제주시,50110660,노형동,남성+여성,53830,2438,56268,2019년 7월
2019,8,제주시,50110660,노형동,남성+여성,53953,2380,56333,2019년 8월
2019,9,제주시,50110660,노형동,남성+여성,53953,2463,56416,2019년 9월
2019,10,제주시,50110660,노형동,남성+여성,54095,2432,56527,2019년 10월
2019,11,제주시,50110660,노형동,남성+여성,54223,2409,56632,2019년 11월
2019,12,제주시,50110660,노형동,남성+여성,54222,2389,56611,2019년 12월
2020,1,제주시,50110660,노형동,남성+여성,54148,2400,56548,2020년 1월
2020,2,제주시,50110660,노형동,남성+여성,54244,2392,56636,2020년 2월
2020,3,제주시,50110660,노형동,남성+여성,54193,2353,56546,2020년 3월
2020,4,제주시,50110660,노형동,남성+여성,54254,2331,56585,2020년 4월
2020,5,제주시,50110660,노형동,남성+여성,54309,2306,56615,2020년 5월
2020,6,제주시,50110660,노형동,남성+여성,54345,2290,56635,2020년 6월
2020,7,제주시,50110660,노형동,남성+여성,54408,2272,56680,2020년 7월
2020,8,제주시,50110660,노형동,남성+여성,54517,2229,56746,2020년 8월
2020,9,제주시,50110660,노형동,남성+여성,54498,2186,56684,2020년 9월
2020,10,제주시,50110660,노형동,남성+여성,54739,2161,56900,2020년 10월
2020,11,제주시,50110660,노형동,남성+여성,54895,2138,57033,2020년 11월
2020,12,제주시,50110660,노형동,남성+여성,55087,2103,57190,2020년 12월
2021,1,제주시,50110660,노형동,남성+여성,55106,2077,57183,2021년 1월
2021,2,제주시,50110660,노형동,남성+여성,55146,2057,57203,2021년 2월
2021,3,제주시,50110660,노형동,남성+여성,55083,2072,57155,2021년 3월
2021,4,제주시,50110660,노형동,남성+여성,55222,2090,57312,2021년 4월
2021,5,제주시,50110660,노형동,남성+여성,55326,2069,57395,2021년 5월
2021,6,제주시,50110660,노형동,남성+여성,55385,2088,57473,2021년 6월
2018,1,서귀포시,50130590,대륜동,남성+여성,13473,178,13651,2018년 1월
2018,2,서귀포시,50130590,대륜동,남성+여성,13519,180,13699,2018년 2월
2018,3,서귀포시,50130590,대륜동,남성+여성,13669,182,13851,2018년 3월
2018,4,서귀포시,50130590,대륜동,남성+여성,13687,183,13870,2018년 4월
2018,5,서귀포시,50130590,대륜동,남성+여성,13743,177,13920,2018년 5월
2018,6,서귀포시,50130590,대륜동,남성+여성,13775,182,13957,2018년 6월
2018,7,서귀포시,50130590,대륜동,남성+여성,13853,185,14038,2018년 7월
2018,8,서귀포시,50130590,대륜동,남성+여성,13868,190,14058,2018년 8월
2018,9,서귀포시,50130590,대륜동,남성+여성,13903,198,14101,2018년 9월
2018,10,서귀포시,50130590,대륜동,남성+여성,13929,198,14127,2018년 10월
2018,11,서귀포시,50130590,대륜동,남성+여성,13949,199,14148,2018년 11월
2018,12,서귀포시,50130590,대륜동,남성+여성,13958,198,14156,2018년 12월
2019,1,서귀포시,50130590,대륜동,남성+여성,14143,210,14353,2019년 1월
2019,2,서귀포시,50130590,대륜동,남성+여성,14266,214,14480,2019년 2월
2019,3,서귀포시,50130590,대륜동,남성+여성,14331,209,14540,2019년 3월
2019,4,서귀포시,50130590,대륜동,남성+여성,14347,209,14556,2019년 4월
2019,5,서귀포시,50130590,대륜동,남성+여성,14364,210,14574,2019년 5월
2019,6,서귀포시,50130590,대륜동,남성+여성,14337,215,14552,2019년 6월
2019,7,서귀포시,50130590,대륜동,남성+여성,14356,213,14569,2019년 7월
2019,8,서귀포시,50130590,대륜동,남성+여성,14346,214,14560,2019년 8월
2019,9,서귀포시,50130590,대륜동,남성+여성,14353,226,14579,2019년 9월
2019,10,서귀포시,50130590,대륜동,남성+여성,14374,221,14595,2019년 10월
2019,11,서귀포시,50130590,대륜동,남성+여성,14390,221,14611,2019년 11월
2019,12,서귀포시,50130590,대륜동,남성+여성,14443,214,14657,2019년 12월
2020,1,서귀포시,50130590,대륜동,남성+여성,14477,215,14692,2020년 1월
2020,2,서귀포시,50130590,대륜동,남성+여성,14492,221,14713,2020년 2월
2020,3,서귀포시,50130590,대륜동,남성+여성,14464,214,14678,2020년 3월
2020,4,서귀포시,50130590,대륜동,남성+여성,14461,213,14674,2020년 4월
2020,5,서귀포시,50130590,대륜동,남성+여성,14467,208,14675,2020년 5월
2020,6,서귀포시,50130590,대륜동,남성+여성,14514,211,14725,2020년 6월
2020,7,서귀포시,50130590,대륜동,남성+여성,14538,212,14750,2020년 7월
2020,8,서귀포시,50130590,대륜동,남성+여성,14556,214,14770,2020년 8월
2020,9,서귀포시,50130590,대륜동,남성+여성,14571,209,14780,2020년 9월
2020,10,서귀포시,50130590,대륜동,남성+여성,14625,206,14831,2020년 10월
2020,11,서귀포시,50130590,대륜동,남성+여성,14652,202,14854,2020년 11월
2020,12,서귀포시,50130590,대륜동,남성+여성,14765,198,14963,2020년 12월
2021,1,서귀포시,50130590,대륜동,남성+여성,14826,196,15022,2021년 1월
2021,2,서귀포시,50130590,대륜동,남성+여성,14906,191,15097,2021년 2월
2021,3,서귀포시,50130590,대륜동,남성+여성,14958,188,15146,2021년 3월
2021,4,서귀포시,50130590,대륜동,남성+여성,15033,190,15223,2021년 4월
2021,5,서귀포시,50130590,대륜동,남성+여성,15052,187,15239,2021년 5월
2021,6,서귀포시,50130590,대륜동,남성+여성,15084,193,15277,2021년 6월
2018,1,서귀포시,50130250,대정읍,남성+여성,21085,1518,22603,2018년 1월
2018,2,서귀포시,50130250,대정읍,남성+여성,21127,1503,22630,2018년 2월
2018,3,서귀포시,50130250,대정읍,남성+여성,21171,1499,22670,2018년 3월
2018,4,서귀포시,50130250,대정읍,남성+여성,21213,1507,22720,2018년 4월
2018,5,서귀포시,50130250,대정읍,남성+여성,21292,1524,22816,2018년 5월
2018,6,서귀포시,50130250,대정읍,남성+여성,21247,1525,22772,2018년 6월
2018,7,서귀포시,50130250,대정읍,남성+여성,21280,1514,22794,2018년 7월
2018,8,서귀포시,50130250,대정읍,남성+여성,21459,1728,23187,2018년 8월
2018,9,서귀포시,50130250,대정읍,남성+여성,21444,1713,23157,2018년 9월
2018,10,서귀포시,50130250,대정읍,남성+여성,21413,1718,23131,2018년 10월
2018,11,서귀포시,50130250,대정읍,남성+여성,21392,1727,23119,2018년 11월
2018,12,서귀포시,50130250,대정읍,남성+여성,21364,1730,23094,2018년 12월
2019,1,서귀포시,50130250,대정읍,남성+여성,21337,1746,23083,2019년 1월
2019,2,서귀포시,50130250,대정읍,남성+여성,21349,1735,23084,2019년 2월
2019,3,서귀포시,50130250,대정읍,남성+여성,21388,1727,23115,2019년 3월
2019,4,서귀포시,50130250,대정읍,남성+여성,21425,1730,23155,2019년 4월
2019,5,서귀포시,50130250,대정읍,남성+여성,21415,1721,23136,2019년 5월
2019,6,서귀포시,50130250,대정읍,남성+여성,21334,1630,22964,2019년 6월
2019,7,서귀포시,50130250,대정읍,남성+여성,21332,1612,22944,2019년 7월
2019,8,서귀포시,50130250,대정읍,남성+여성,21408,1813,23221,2019년 8월
2019,9,서귀포시,50130250,대정읍,남성+여성,21379,1783,23162,2019년 9월
2019,10,서귀포시,50130250,대정읍,남성+여성,21348,1784,23132,2019년 10월
2019,11,서귀포시,50130250,대정읍,남성+여성,21367,1784,23151,2019년 11월
2019,12,서귀포시,50130250,대정읍,남성+여성,21334,1771,23105,2019년 12월
2020,1,서귀포시,50130250,대정읍,남성+여성,21354,1784,23138,2020년 1월
2020,2,서귀포시,50130250,대정읍,남성+여성,21329,1783,23112,2020년 2월
2020,3,서귀포시,50130250,대정읍,남성+여성,21338,1768,23106,2020년 3월
2020,4,서귀포시,50130250,대정읍,남성+여성,21313,1765,23078,2020년 4월
2020,5,서귀포시,50130250,대정읍,남성+여성,21316,1737,23053,2020년 5월
2020,6,서귀포시,50130250,대정읍,남성+여성,21298,1672,22970,2020년 6월
2020,7,서귀포시,50130250,대정읍,남성+여성,21328,1631,22959,2020년 7월
2020,8,서귀포시,50130250,대정읍,남성+여성,21431,1731,23162,2020년 8월
2020,9,서귀포시,50130250,대정읍,남성+여성,21528,1735,23263,2020년 9월
2020,10,서귀포시,50130250,대정읍,남성+여성,21616,1720,23336,2020년 10월
2020,11,서귀포시,50130250,대정읍,남성+여성,21720,1708,23428,2020년 11월
2020,12,서귀포시,50130250,대정읍,남성+여성,21761,1690,23451,2020년 12월
2021,1,서귀포시,50130250,대정읍,남성+여성,21816,1687,23503,2021년 1월
2021,2,서귀포시,50130250,대정읍,남성+여성,21947,1696,23643,2021년 2월
2021,3,서귀포시,50130250,대정읍,남성+여성,21883,1687,23570,2021년 3월
2021,4,서귀포시,50130250,대정읍,남성+여성,21859,1682,23541,2021년 4월
2021,5,서귀포시,50130250,대정읍,남성+여성,21919,1678,23597,2021년 5월
2021,6,서귀포시,50130250,대정읍,남성+여성,21959,1571,23530,2021년 6월
2018,1,서귀포시,50130600,대천동,남성+여성,13160,244,13404,2018년 1월
2018,2,서귀포시,50130600,대천동,남성+여성,13253,243,13496,2018년 2월
2018,3,서귀포시,50130600,대천동,남성+여성,13348,244,13592,2018년 3월
2018,4,서귀포시,50130600,대천동,남성+여성,13351,245,13596,2018년 4월
2018,5,서귀포시,50130600,대천동,남성+여성,13358,239,13597,2018년 5월
2018,6,서귀포시,50130600,대천동,남성+여성,13358,239,13597,2018년 6월
2018,7,서귀포시,50130600,대천동,남성+여성,13511,243,13754,2018년 7월
2018,8,서귀포시,50130600,대천동,남성+여성,13524,243,13767,2018년 8월
2018,9,서귀포시,50130600,대천동,남성+여성,13563,248,13811,2018년 9월
2018,10,서귀포시,50130600,대천동,남성+여성,13626,251,13877,2018년 10월
2018,11,서귀포시,50130600,대천동,남성+여성,13616,256,13872,2018년 11월
2018,12,서귀포시,50130600,대천동,남성+여성,13675,255,13930,2018년 12월
2019,1,서귀포시,50130600,대천동,남성+여성,13659,257,13916,2019년 1월
2019,2,서귀포시,50130600,대천동,남성+여성,13612,252,13864,2019년 2월
2019,3,서귀포시,50130600,대천동,남성+여성,13652,239,13891,2019년 3월
2019,4,서귀포시,50130600,대천동,남성+여성,13649,234,13883,2019년 4월
2019,5,서귀포시,50130600,대천동,남성+여성,13659,227,13886,2019년 5월
2019,6,서귀포시,50130600,대천동,남성+여성,13722,228,13950,2019년 6월
2019,7,서귀포시,50130600,대천동,남성+여성,13724,232,13956,2019년 7월
2019,8,서귀포시,50130600,대천동,남성+여성,13758,234,13992,2019년 8월
2019,9,서귀포시,50130600,대천동,남성+여성,13800,234,14034,2019년 9월
2019,10,서귀포시,50130600,대천동,남성+여성,13804,228,14032,2019년 10월
2019,11,서귀포시,50130600,대천동,남성+여성,13759,237,13996,2019년 11월
2019,12,서귀포시,50130600,대천동,남성+여성,13785,225,14010,2019년 12월
2020,1,서귀포시,50130600,대천동,남성+여성,13756,224,13980,2020년 1월
2020,2,서귀포시,50130600,대천동,남성+여성,13790,224,14014,2020년 2월
2020,3,서귀포시,50130600,대천동,남성+여성,13757,217,13974,2020년 3월
2020,4,서귀포시,50130600,대천동,남성+여성,13839,215,14054,2020년 4월
2020,5,서귀포시,50130600,대천동,남성+여성,13819,208,14027,2020년 5월
2020,6,서귀포시,50130600,대천동,남성+여성,13820,202,14022,2020년 6월
2020,7,서귀포시,50130600,대천동,남성+여성,13826,194,14020,2020년 7월
2020,8,서귀포시,50130600,대천동,남성+여성,13829,198,14027,2020년 8월
2020,9,서귀포시,50130600,대천동,남성+여성,13816,198,14014,2020년 9월
2020,10,서귀포시,50130600,대천동,남성+여성,13890,198,14088,2020년 10월
2020,11,서귀포시,50130600,대천동,남성+여성,13986,197,14183,2020년 11월
2020,12,서귀포시,50130600,대천동,남성+여성,13921,189,14110,2020년 12월
2021,1,서귀포시,50130600,대천동,남성+여성,13900,183,14083,2021년 1월
2021,2,서귀포시,50130600,대천동,남성+여성,13909,181,14090,2021년 2월
2021,3,서귀포시,50130600,대천동,남성+여성,13858,190,14048,2021년 3월
2021,4,서귀포시,50130600,대천동,남성+여성,13878,187,14065,2021년 4월
2021,5,서귀포시,50130600,대천동,남성+여성,13908,184,14092,2021년 5월
2021,6,서귀포시,50130600,대천동,남성+여성,13865,181,14046,2021년 6월
2018,1,제주시,50110690,도두동,남성+여성,3026,98,3124,2018년 1월
2018,2,제주시,50110690,도두동,남성+여성,3033,101,3134,2018년 2월
2018,3,제주시,50110690,도두동,남성+여성,3052,98,3150,2018년 3월
2018,4,제주시,50110690,도두동,남성+여성,3034,99,3133,2018년 4월
2018,5,제주시,50110690,도두동,남성+여성,3018,113,3131,2018년 5월
2018,6,제주시,50110690,도두동,남성+여성,3036,114,3150,2018년 6월
2018,7,제주시,50110690,도두동,남성+여성,3065,136,3201,2018년 7월
2018,8,제주시,50110690,도두동,남성+여성,3079,131,3210,2018년 8월
2018,9,제주시,50110690,도두동,남성+여성,3079,134,3213,2018년 9월
2018,10,제주시,50110690,도두동,남성+여성,3101,152,3253,2018년 10월
2018,11,제주시,50110690,도두동,남성+여성,3105,160,3265,2018년 11월
2018,12,제주시,50110690,도두동,남성+여성,3101,156,3257,2018년 12월
2019,1,제주시,50110690,도두동,남성+여성,3076,155,3231,2019년 1월
2019,2,제주시,50110690,도두동,남성+여성,3089,151,3240,2019년 2월
2019,3,제주시,50110690,도두동,남성+여성,3106,167,3273,2019년 3월
2019,4,제주시,50110690,도두동,남성+여성,3113,166,3279,2019년 4월
2019,5,제주시,50110690,도두동,남성+여성,3117,162,3279,2019년 5월
2019,6,제주시,50110690,도두동,남성+여성,3126,172,3298,2019년 6월
2019,7,제주시,50110690,도두동,남성+여성,3120,157,3277,2019년 7월
2019,8,제주시,50110690,도두동,남성+여성,3150,153,3303,2019년 8월
2019,9,제주시,50110690,도두동,남성+여성,3151,145,3296,2019년 9월
2019,10,제주시,50110690,도두동,남성+여성,3180,135,3315,2019년 10월
2019,11,제주시,50110690,도두동,남성+여성,3176,131,3307,2019년 11월
2019,12,제주시,50110690,도두동,남성+여성,3186,128,3314,2019년 12월
2020,1,제주시,50110690,도두동,남성+여성,3202,128,3330,2020년 1월
2020,2,제주시,50110690,도두동,남성+여성,3221,130,3351,2020년 2월
2020,3,제주시,50110690,도두동,남성+여성,3202,125,3327,2020년 3월
2020,4,제주시,50110690,도두동,남성+여성,3210,126,3336,2020년 4월
2020,5,제주시,50110690,도두동,남성+여성,3212,121,3333,2020년 5월
2020,6,제주시,50110690,도두동,남성+여성,3230,122,3352,2020년 6월
2020,7,제주시,50110690,도두동,남성+여성,3246,118,3364,2020년 7월
2020,8,제주시,50110690,도두동,남성+여성,3234,116,3350,2020년 8월
2020,9,제주시,50110690,도두동,남성+여성,3237,118,3355,2020년 9월
2020,10,제주시,50110690,도두동,남성+여성,3244,111,3355,2020년 10월
2020,11,제주시,50110690,도두동,남성+여성,3255,110,3365,2020년 11월
2020,12,제주시,50110690,도두동,남성+여성,3262,105,3367,2020년 12월
2021,1,제주시,50110690,도두동,남성+여성,3270,100,3370,2021년 1월
2021,2,제주시,50110690,도두동,남성+여성,3264,98,3362,2021년 2월
2021,3,제주시,50110690,도두동,남성+여성,3270,97,3367,2021년 3월
2021,4,제주시,50110690,도두동,남성+여성,3283,98,3381,2021년 4월
2021,5,제주시,50110690,도두동,남성+여성,3291,94,3385,2021년 5월
2021,6,제주시,50110690,도두동,남성+여성,3313,90,3403,2021년 6월
2018,1,서귀포시,50130570,동홍동,남성+여성,22693,1266,23959,2018년 1월
2018,2,서귀포시,50130570,동홍동,남성+여성,22727,1255,23982,2018년 2월
2018,3,서귀포시,50130570,동홍동,남성+여성,22717,1246,23963,2018년 3월
2018,4,서귀포시,50130570,동홍동,남성+여성,22721,1239,23960,2018년 4월
2018,5,서귀포시,50130570,동홍동,남성+여성,22713,1235,23948,2018년 5월
2018,6,서귀포시,50130570,동홍동,남성+여성,22751,1243,23994,2018년 6월
2018,7,서귀포시,50130570,동홍동,남성+여성,22781,1252,24033,2018년 7월
2018,8,서귀포시,50130570,동홍동,남성+여성,22797,1256,24053,2018년 8월
2018,9,서귀포시,50130570,동홍동,남성+여성,22835,1275,24110,2018년 9월
2018,10,서귀포시,50130570,동홍동,남성+여성,22853,1271,24124,2018년 10월
2018,11,서귀포시,50130570,동홍동,남성+여성,22882,1282,24164,2018년 11월
2018,12,서귀포시,50130570,동홍동,남성+여성,22885,1278,24163,2018년 12월
2019,1,서귀포시,50130570,동홍동,남성+여성,22884,1286,24170,2019년 1월
2019,2,서귀포시,50130570,동홍동,남성+여성,22876,1289,24165,2019년 2월
2019,3,서귀포시,50130570,동홍동,남성+여성,22842,1296,24138,2019년 3월
2019,4,서귀포시,50130570,동홍동,남성+여성,22827,1294,24121,2019년 4월
2019,5,서귀포시,50130570,동홍동,남성+여성,22865,1286,24151,2019년 5월
2019,6,서귀포시,50130570,동홍동,남성+여성,22892,1293,24185,2019년 6월
2019,7,서귀포시,50130570,동홍동,남성+여성,22884,1275,24159,2019년 7월
2019,8,서귀포시,50130570,동홍동,남성+여성,22948,1279,24227,2019년 8월
2019,9,서귀포시,50130570,동홍동,남성+여성,23023,1278,24301,2019년 9월
2019,10,서귀포시,50130570,동홍동,남성+여성,23061,1273,24334,2019년 10월
2019,11,서귀포시,50130570,동홍동,남성+여성,23104,1276,24380,2019년 11월
2019,12,서귀포시,50130570,동홍동,남성+여성,23118,1271,24389,2019년 12월
2020,1,서귀포시,50130570,동홍동,남성+여성,23137,1271,24408,2020년 1월
2020,2,서귀포시,50130570,동홍동,남성+여성,23136,1270,24406,2020년 2월
2020,3,서귀포시,50130570,동홍동,남성+여성,23187,1245,24432,2020년 3월
2020,4,서귀포시,50130570,동홍동,남성+여성,23179,1239,24418,2020년 4월
2020,5,서귀포시,50130570,동홍동,남성+여성,23185,1215,24400,2020년 5월
2020,6,서귀포시,50130570,동홍동,남성+여성,23166,1202,24368,2020년 6월
2020,7,서귀포시,50130570,동홍동,남성+여성,23215,1174,24389,2020년 7월
2020,8,서귀포시,50130570,동홍동,남성+여성,23202,1150,24352,2020년 8월
2020,9,서귀포시,50130570,동홍동,남성+여성,23258,1107,24365,2020년 9월
2020,10,서귀포시,50130570,동홍동,남성+여성,23233,1047,24280,2020년 10월
2020,11,서귀포시,50130570,동홍동,남성+여성,23237,1000,24237,2020년 11월
2020,12,서귀포시,50130570,동홍동,남성+여성,23233,989,24222,2020년 12월
2021,1,서귀포시,50130570,동홍동,남성+여성,23187,979,24166,2021년 1월
2021,2,서귀포시,50130570,동홍동,남성+여성,23219,951,24170,2021년 2월
2021,3,서귀포시,50130570,동홍동,남성+여성,23203,942,24145,2021년 3월
2021,4,서귀포시,50130570,동홍동,남성+여성,23193,911,24104,2021년 4월
2021,5,서귀포시,50130570,동홍동,남성+여성,23204,907,24111,2021년 5월
2021,6,서귀포시,50130570,동홍동,남성+여성,23205,892,24097,2021년 6월
2018,1,제주시,50110620,봉개동,남성+여성,3927,76,4003,2018년 1월
2018,2,제주시,50110620,봉개동,남성+여성,3960,77,4037,2018년 2월
2018,3,제주시,50110620,봉개동,남성+여성,3979,73,4052,2018년 3월
2018,4,제주시,50110620,봉개동,남성+여성,3982,75,4057,2018년 4월
2018,5,제주시,50110620,봉개동,남성+여성,3979,77,4056,2018년 5월
2018,6,제주시,50110620,봉개동,남성+여성,3974,80,4054,2018년 6월
2018,7,제주시,50110620,봉개동,남성+여성,4003,83,4086,2018년 7월
2018,8,제주시,50110620,봉개동,남성+여성,4016,85,4101,2018년 8월
2018,9,제주시,50110620,봉개동,남성+여성,4041,86,4127,2018년 9월
2018,10,제주시,50110620,봉개동,남성+여성,4060,86,4146,2018년 10월
2018,11,제주시,50110620,봉개동,남성+여성,4278,87,4365,2018년 11월
2018,12,제주시,50110620,봉개동,남성+여성,4842,94,4936,2018년 12월
2019,1,제주시,50110620,봉개동,남성+여성,4997,96,5093,2019년 1월
2019,2,제주시,50110620,봉개동,남성+여성,5094,97,5191,2019년 2월
2019,3,제주시,50110620,봉개동,남성+여성,5159,98,5257,2019년 3월
2019,4,제주시,50110620,봉개동,남성+여성,5181,102,5283,2019년 4월
2019,5,제주시,50110620,봉개동,남성+여성,5204,102,5306,2019년 5월
2019,6,제주시,50110620,봉개동,남성+여성,5225,97,5322,2019년 6월
2019,7,제주시,50110620,봉개동,남성+여성,5209,94,5303,2019년 7월
2019,8,제주시,50110620,봉개동,남성+여성,5216,90,5306,2019년 8월
2019,9,제주시,50110620,봉개동,남성+여성,5236,92,5328,2019년 9월
2019,10,제주시,50110620,봉개동,남성+여성,5230,95,5325,2019년 10월
2019,11,제주시,50110620,봉개동,남성+여성,5255,92,5347,2019년 11월
2019,12,제주시,50110620,봉개동,남성+여성,5270,93,5363,2019년 12월
2020,1,제주시,50110620,봉개동,남성+여성,5272,94,5366,2020년 1월
2020,2,제주시,50110620,봉개동,남성+여성,5265,96,5361,2020년 2월
2020,3,제주시,50110620,봉개동,남성+여성,5258,95,5353,2020년 3월
2020,4,제주시,50110620,봉개동,남성+여성,5272,92,5364,2020년 4월
2020,5,제주시,50110620,봉개동,남성+여성,5248,89,5337,2020년 5월
2020,6,제주시,50110620,봉개동,남성+여성,5264,90,5354,2020년 6월
2020,7,제주시,50110620,봉개동,남성+여성,5278,86,5364,2020년 7월
2020,8,제주시,50110620,봉개동,남성+여성,5274,87,5361,2020년 8월
2020,9,제주시,50110620,봉개동,남성+여성,5241,87,5328,2020년 9월
2020,10,제주시,50110620,봉개동,남성+여성,5245,85,5330,2020년 10월
2020,11,제주시,50110620,봉개동,남성+여성,5239,81,5320,2020년 11월
2020,12,제주시,50110620,봉개동,남성+여성,5285,87,5372,2020년 12월
2021,1,제주시,50110620,봉개동,남성+여성,5287,85,5372,2021년 1월
2021,2,제주시,50110620,봉개동,남성+여성,5307,82,5389,2021년 2월
2021,3,제주시,50110620,봉개동,남성+여성,5281,81,5362,2021년 3월
2021,4,제주시,50110620,봉개동,남성+여성,5271,82,5353,2021년 4월
2021,5,제주시,50110620,봉개동,남성+여성,5255,82,5337,2021년 5월
2021,6,제주시,50110620,봉개동,남성+여성,5246,81,5327,2021년 6월
2018,1,제주시,50110550,삼도1동,남성+여성,14405,141,14546,2018년 1월
2018,2,제주시,50110550,삼도1동,남성+여성,14410,147,14557,2018년 2월
2018,3,제주시,50110550,삼도1동,남성+여성,14380,154,14534,2018년 3월
2018,4,제주시,50110550,삼도1동,남성+여성,14342,171,14513,2018년 4월
2018,5,제주시,50110550,삼도1동,남성+여성,14307,435,14742,2018년 5월
2018,6,제주시,50110550,삼도1동,남성+여성,14279,287,14566,2018년 6월
2018,7,제주시,50110550,삼도1동,남성+여성,14281,236,14517,2018년 7월
2018,8,제주시,50110550,삼도1동,남성+여성,14279,222,14501,2018년 8월
2018,9,제주시,50110550,삼도1동,남성+여성,14299,211,14510,2018년 9월
2018,10,제주시,50110550,삼도1동,남성+여성,14277,191,14468,2018년 10월
2018,11,제주시,50110550,삼도1동,남성+여성,14260,160,14420,2018년 11월
2018,12,제주시,50110550,삼도1동,남성+여성,14190,155,14345,2018년 12월
2019,1,제주시,50110550,삼도1동,남성+여성,14119,155,14274,2019년 1월
2019,2,제주시,50110550,삼도1동,남성+여성,14036,154,14190,2019년 2월
2019,3,제주시,50110550,삼도1동,남성+여성,14018,155,14173,2019년 3월
2019,4,제주시,50110550,삼도1동,남성+여성,14009,151,14160,2019년 4월
2019,5,제주시,50110550,삼도1동,남성+여성,13981,146,14127,2019년 5월
2019,6,제주시,50110550,삼도1동,남성+여성,13947,149,14096,2019년 6월
2019,7,제주시,50110550,삼도1동,남성+여성,13982,148,14130,2019년 7월
2019,8,제주시,50110550,삼도1동,남성+여성,13951,149,14100,2019년 8월
2019,9,제주시,50110550,삼도1동,남성+여성,13924,152,14076,2019년 9월
2019,10,제주시,50110550,삼도1동,남성+여성,13886,156,14042,2019년 10월
2019,11,제주시,50110550,삼도1동,남성+여성,13867,154,14021,2019년 11월
2019,12,제주시,50110550,삼도1동,남성+여성,13854,151,14005,2019년 12월
2020,1,제주시,50110550,삼도1동,남성+여성,13771,149,13920,2020년 1월
2020,2,제주시,50110550,삼도1동,남성+여성,13743,149,13892,2020년 2월
2020,3,제주시,50110550,삼도1동,남성+여성,13711,147,13858,2020년 3월
2020,4,제주시,50110550,삼도1동,남성+여성,13697,154,13851,2020년 4월
2020,5,제주시,50110550,삼도1동,남성+여성,13671,155,13826,2020년 5월
2020,6,제주시,50110550,삼도1동,남성+여성,13692,150,13842,2020년 6월
2020,7,제주시,50110550,삼도1동,남성+여성,13671,148,13819,2020년 7월
2020,8,제주시,50110550,삼도1동,남성+여성,13655,142,13797,2020년 8월
2020,9,제주시,50110550,삼도1동,남성+여성,13616,140,13756,2020년 9월
2020,10,제주시,50110550,삼도1동,남성+여성,13589,135,13724,2020년 10월
2020,11,제주시,50110550,삼도1동,남성+여성,13596,132,13728,2020년 11월
2020,12,제주시,50110550,삼도1동,남성+여성,13586,133,13719,2020년 12월
2021,1,제주시,50110550,삼도1동,남성+여성,13579,136,13715,2021년 1월
2021,2,제주시,50110550,삼도1동,남성+여성,13569,137,13706,2021년 2월
2021,3,제주시,50110550,삼도1동,남성+여성,13523,135,13658,2021년 3월
2021,4,제주시,50110550,삼도1동,남성+여성,13503,134,13637,2021년 4월
2021,5,제주시,50110550,삼도1동,남성+여성,13525,138,13663,2021년 5월
2021,6,제주시,50110550,삼도1동,남성+여성,13513,138,13651,2021년 6월
2018,1,제주시,50110560,삼도2동,남성+여성,8688,222,8910,2018년 1월
2018,2,제주시,50110560,삼도2동,남성+여성,8696,225,8921,2018년 2월
2018,3,제주시,50110560,삼도2동,남성+여성,8675,216,8891,2018년 3월
2018,4,제주시,50110560,삼도2동,남성+여성,8656,228,8884,2018년 4월
2018,5,제주시,50110560,삼도2동,남성+여성,8617,254,8871,2018년 5월
2018,6,제주시,50110560,삼도2동,남성+여성,8601,266,8867,2018년 6월
2018,7,제주시,50110560,삼도2동,남성+여성,8567,270,8837,2018년 7월
2018,8,제주시,50110560,삼도2동,남성+여성,8510,273,8783,2018년 8월
2018,9,제주시,50110560,삼도2동,남성+여성,8484,262,8746,2018년 9월
2018,10,제주시,50110560,삼도2동,남성+여성,8448,267,8715,2018년 10월
2018,11,제주시,50110560,삼도2동,남성+여성,8407,270,8677,2018년 11월
2018,12,제주시,50110560,삼도2동,남성+여성,8397,265,8662,2018년 12월
2019,1,제주시,50110560,삼도2동,남성+여성,8394,282,8676,2019년 1월
2019,2,제주시,50110560,삼도2동,남성+여성,8345,273,8618,2019년 2월
2019,3,제주시,50110560,삼도2동,남성+여성,8319,267,8586,2019년 3월
2019,4,제주시,50110560,삼도2동,남성+여성,8264,281,8545,2019년 4월
2019,5,제주시,50110560,삼도2동,남성+여성,8254,275,8529,2019년 5월
2019,6,제주시,50110560,삼도2동,남성+여성,8239,271,8510,2019년 6월
2019,7,제주시,50110560,삼도2동,남성+여성,8228,263,8491,2019년 7월
2019,8,제주시,50110560,삼도2동,남성+여성,8196,266,8462,2019년 8월
2019,9,제주시,50110560,삼도2동,남성+여성,8214,256,8470,2019년 9월
2019,10,제주시,50110560,삼도2동,남성+여성,8186,255,8441,2019년 10월
2019,11,제주시,50110560,삼도2동,남성+여성,8182,267,8449,2019년 11월
2019,12,제주시,50110560,삼도2동,남성+여성,8174,259,8433,2019년 12월
2020,1,제주시,50110560,삼도2동,남성+여성,8141,261,8402,2020년 1월
2020,2,제주시,50110560,삼도2동,남성+여성,8116,267,8383,2020년 2월
2020,3,제주시,50110560,삼도2동,남성+여성,8075,271,8346,2020년 3월
2020,4,제주시,50110560,삼도2동,남성+여성,8109,268,8377,2020년 4월
2020,5,제주시,50110560,삼도2동,남성+여성,8100,262,8362,2020년 5월
2020,6,제주시,50110560,삼도2동,남성+여성,8067,260,8327,2020년 6월
2020,7,제주시,50110560,삼도2동,남성+여성,8074,261,8335,2020년 7월
2020,8,제주시,50110560,삼도2동,남성+여성,8068,259,8327,2020년 8월
2020,9,제주시,50110560,삼도2동,남성+여성,8078,267,8345,2020년 9월
2020,10,제주시,50110560,삼도2동,남성+여성,8077,261,8338,2020년 10월
2020,11,제주시,50110560,삼도2동,남성+여성,8052,256,8308,2020년 11월
2020,12,제주시,50110560,삼도2동,남성+여성,8005,270,8275,2020년 12월
2021,1,제주시,50110560,삼도2동,남성+여성,7949,264,8213,2021년 1월
2021,2,제주시,50110560,삼도2동,남성+여성,7947,259,8206,2021년 2월
2021,3,제주시,50110560,삼도2동,남성+여성,7941,260,8201,2021년 3월
2021,4,제주시,50110560,삼도2동,남성+여성,7923,248,8171,2021년 4월
2021,5,제주시,50110560,삼도2동,남성+여성,7943,251,8194,2021년 5월
2021,6,제주시,50110560,삼도2동,남성+여성,7939,250,8189,2021년 6월
2018,1,제주시,50110610,삼양동,남성+여성,23835,245,24080,2018년 1월
2018,2,제주시,50110610,삼양동,남성+여성,24065,248,24313,2018년 2월
2018,3,제주시,50110610,삼양동,남성+여성,24107,248,24355,2018년 3월
2018,4,제주시,50110610,삼양동,남성+여성,24143,249,24392,2018년 4월
2018,5,제주시,50110610,삼양동,남성+여성,24208,247,24455,2018년 5월
2018,6,제주시,50110610,삼양동,남성+여성,24306,240,24546,2018년 6월
2018,7,제주시,50110610,삼양동,남성+여성,24464,242,24706,2018년 7월
2018,8,제주시,50110610,삼양동,남성+여성,24561,247,24808,2018년 8월
2018,9,제주시,50110610,삼양동,남성+여성,24622,248,24870,2018년 9월
2018,10,제주시,50110610,삼양동,남성+여성,24773,257,25030,2018년 10월
2018,11,제주시,50110610,삼양동,남성+여성,24903,254,25157,2018년 11월
2018,12,제주시,50110610,삼양동,남성+여성,24897,256,25153,2018년 12월
2019,1,제주시,50110610,삼양동,남성+여성,25027,255,25282,2019년 1월
2019,2,제주시,50110610,삼양동,남성+여성,25043,252,25295,2019년 2월
2019,3,제주시,50110610,삼양동,남성+여성,25108,254,25362,2019년 3월
2019,4,제주시,50110610,삼양동,남성+여성,25160,255,25415,2019년 4월
2019,5,제주시,50110610,삼양동,남성+여성,25210,249,25459,2019년 5월
2019,6,제주시,50110610,삼양동,남성+여성,25332,248,25580,2019년 6월
2019,7,제주시,50110610,삼양동,남성+여성,25398,248,25646,2019년 7월
2019,8,제주시,50110610,삼양동,남성+여성,25447,256,25703,2019년 8월
2019,9,제주시,50110610,삼양동,남성+여성,25461,259,25720,2019년 9월
2019,10,제주시,50110610,삼양동,남성+여성,25544,257,25801,2019년 10월
2019,11,제주시,50110610,삼양동,남성+여성,25611,262,25873,2019년 11월
2019,12,제주시,50110610,삼양동,남성+여성,25702,263,25965,2019년 12월
2020,1,제주시,50110610,삼양동,남성+여성,25712,260,25972,2020년 1월
2020,2,제주시,50110610,삼양동,남성+여성,25729,260,25989,2020년 2월
2020,3,제주시,50110610,삼양동,남성+여성,25756,257,26013,2020년 3월
2020,4,제주시,50110610,삼양동,남성+여성,25726,254,25980,2020년 4월
2020,5,제주시,50110610,삼양동,남성+여성,25743,250,25993,2020년 5월
2020,6,제주시,50110610,삼양동,남성+여성,25724,252,25976,2020년 6월
2020,7,제주시,50110610,삼양동,남성+여성,25745,247,25992,2020년 7월
2020,8,제주시,50110610,삼양동,남성+여성,25794,245,26039,2020년 8월
2020,9,제주시,50110610,삼양동,남성+여성,25779,243,26022,2020년 9월
2020,10,제주시,50110610,삼양동,남성+여성,25777,243,26020,2020년 10월
2020,11,제주시,50110610,삼양동,남성+여성,25765,237,26002,2020년 11월
2020,12,제주시,50110610,삼양동,남성+여성,25837,242,26079,2020년 12월
2021,1,제주시,50110610,삼양동,남성+여성,25844,235,26079,2021년 1월
2021,2,제주시,50110610,삼양동,남성+여성,25852,232,26084,2021년 2월
2021,3,제주시,50110610,삼양동,남성+여성,25770,224,25994,2021년 3월
2021,4,제주시,50110610,삼양동,남성+여성,25767,226,25993,2021년 4월
2021,5,제주시,50110610,삼양동,남성+여성,25803,225,26028,2021년 5월
2021,6,제주시,50110610,삼양동,남성+여성,25797,224,26021,2021년 6월
2018,1,서귀포시,50130580,서홍동,남성+여성,10637,127,10764,2018년 1월
2018,2,서귀포시,50130580,서홍동,남성+여성,10666,123,10789,2018년 2월
2018,3,서귀포시,50130580,서홍동,남성+여성,10668,126,10794,2018년 3월
2018,4,서귀포시,50130580,서홍동,남성+여성,10644,123,10767,2018년 4월
2018,5,서귀포시,50130580,서홍동,남성+여성,10647,122,10769,2018년 5월
2018,6,서귀포시,50130580,서홍동,남성+여성,10641,125,10766,2018년 6월
2018,7,서귀포시,50130580,서홍동,남성+여성,10635,124,10759,2018년 7월
2018,8,서귀포시,50130580,서홍동,남성+여성,10622,122,10744,2018년 8월
2018,9,서귀포시,50130580,서홍동,남성+여성,10628,127,10755,2018년 9월
2018,10,서귀포시,50130580,서홍동,남성+여성,10625,126,10751,2018년 10월
2018,11,서귀포시,50130580,서홍동,남성+여성,10593,128,10721,2018년 11월
2018,12,서귀포시,50130580,서홍동,남성+여성,10570,127,10697,2018년 12월
2019,1,서귀포시,50130580,서홍동,남성+여성,10523,124,10647,2019년 1월
2019,2,서귀포시,50130580,서홍동,남성+여성,10500,116,10616,2019년 2월
2019,3,서귀포시,50130580,서홍동,남성+여성,10474,114,10588,2019년 3월
2019,4,서귀포시,50130580,서홍동,남성+여성,10471,119,10590,2019년 4월
2019,5,서귀포시,50130580,서홍동,남성+여성,10478,127,10605,2019년 5월
2019,6,서귀포시,50130580,서홍동,남성+여성,10500,124,10624,2019년 6월
2019,7,서귀포시,50130580,서홍동,남성+여성,10505,121,10626,2019년 7월
2019,8,서귀포시,50130580,서홍동,남성+여성,10489,118,10607,2019년 8월
2019,9,서귀포시,50130580,서홍동,남성+여성,10451,121,10572,2019년 9월
2019,10,서귀포시,50130580,서홍동,남성+여성,10421,125,10546,2019년 10월
2019,11,서귀포시,50130580,서홍동,남성+여성,10436,126,10562,2019년 11월
2019,12,서귀포시,50130580,서홍동,남성+여성,10433,126,10559,2019년 12월
2020,1,서귀포시,50130580,서홍동,남성+여성,10479,127,10606,2020년 1월
2020,2,서귀포시,50130580,서홍동,남성+여성,10470,120,10590,2020년 2월
2020,3,서귀포시,50130580,서홍동,남성+여성,10451,119,10570,2020년 3월
2020,4,서귀포시,50130580,서홍동,남성+여성,10424,115,10539,2020년 4월
2020,5,서귀포시,50130580,서홍동,남성+여성,10438,117,10555,2020년 5월
2020,6,서귀포시,50130580,서홍동,남성+여성,10416,119,10535,2020년 6월
2020,7,서귀포시,50130580,서홍동,남성+여성,10413,119,10532,2020년 7월
2020,8,서귀포시,50130580,서홍동,남성+여성,10439,116,10555,2020년 8월
2020,9,서귀포시,50130580,서홍동,남성+여성,10439,117,10556,2020년 9월
2020,10,서귀포시,50130580,서홍동,남성+여성,10553,122,10675,2020년 10월
2020,11,서귀포시,50130580,서홍동,남성+여성,10586,124,10710,2020년 11월
2020,12,서귀포시,50130580,서홍동,남성+여성,10618,128,10746,2020년 12월
2021,1,서귀포시,50130580,서홍동,남성+여성,10743,131,10874,2021년 1월
2021,2,서귀포시,50130580,서홍동,남성+여성,10772,128,10900,2021년 2월
2021,3,서귀포시,50130580,서홍동,남성+여성,10757,121,10878,2021년 3월
2021,4,서귀포시,50130580,서홍동,남성+여성,10810,127,10937,2021년 4월
2021,5,서귀포시,50130580,서홍동,남성+여성,10846,127,10973,2021년 5월
2021,6,서귀포시,50130580,서홍동,남성+여성,10925,129,11054,2021년 6월
2018,1,서귀포시,50130259,성산읍,남성+여성,15338,1575,16913,2018년 1월
2018,2,서귀포시,50130259,성산읍,남성+여성,15385,1560,16945,2018년 2월
2018,3,서귀포시,50130259,성산읍,남성+여성,15412,1539,16951,2018년 3월
2018,4,서귀포시,50130259,성산읍,남성+여성,15446,1548,16994,2018년 4월
2018,5,서귀포시,50130259,성산읍,남성+여성,15466,1558,17024,2018년 5월
2018,6,서귀포시,50130259,성산읍,남성+여성,15495,1638,17133,2018년 6월
2018,7,서귀포시,50130259,성산읍,남성+여성,15491,1659,17150,2018년 7월
2018,8,서귀포시,50130259,성산읍,남성+여성,15495,1700,17195,2018년 8월
2018,9,서귀포시,50130259,성산읍,남성+여성,15519,1731,17250,2018년 9월
2018,10,서귀포시,50130259,성산읍,남성+여성,15559,1735,17294,2018년 10월
2018,11,서귀포시,50130259,성산읍,남성+여성,15519,1732,17251,2018년 11월
2018,12,서귀포시,50130259,성산읍,남성+여성,15450,1730,17180,2018년 12월
2019,1,서귀포시,50130259,성산읍,남성+여성,15432,1730,17162,2019년 1월
2019,2,서귀포시,50130259,성산읍,남성+여성,15464,1729,17193,2019년 2월
2019,3,서귀포시,50130259,성산읍,남성+여성,15495,1706,17201,2019년 3월
2019,4,서귀포시,50130259,성산읍,남성+여성,15504,1724,17228,2019년 4월
2019,5,서귀포시,50130259,성산읍,남성+여성,15484,1753,17237,2019년 5월
2019,6,서귀포시,50130259,성산읍,남성+여성,15499,1767,17266,2019년 6월
2019,7,서귀포시,50130259,성산읍,남성+여성,15545,1782,17327,2019년 7월
2019,8,서귀포시,50130259,성산읍,남성+여성,15597,1772,17369,2019년 8월
2019,9,서귀포시,50130259,성산읍,남성+여성,15606,1790,17396,2019년 9월
2019,10,서귀포시,50130259,성산읍,남성+여성,15606,1782,17388,2019년 10월
2019,11,서귀포시,50130259,성산읍,남성+여성,15604,1810,17414,2019년 11월
2019,12,서귀포시,50130259,성산읍,남성+여성,15557,1781,17338,2019년 12월
2020,1,서귀포시,50130259,성산읍,남성+여성,15489,1802,17291,2020년 1월
2020,2,서귀포시,50130259,성산읍,남성+여성,15434,1791,17225,2020년 2월
2020,3,서귀포시,50130259,성산읍,남성+여성,15341,1766,17107,2020년 3월
2020,4,서귀포시,50130259,성산읍,남성+여성,15290,1752,17042,2020년 4월
2020,5,서귀포시,50130259,성산읍,남성+여성,15290,1733,17023,2020년 5월
2020,6,서귀포시,50130259,성산읍,남성+여성,15302,1724,17026,2020년 6월
2020,7,서귀포시,50130259,성산읍,남성+여성,15284,1716,17000,2020년 7월
2020,8,서귀포시,50130259,성산읍,남성+여성,15300,1714,17014,2020년 8월
2020,9,서귀포시,50130259,성산읍,남성+여성,15297,1692,16989,2020년 9월
2020,10,서귀포시,50130259,성산읍,남성+여성,15288,1680,16968,2020년 10월
2020,11,서귀포시,50130259,성산읍,남성+여성,15306,1669,16975,2020년 11월
2020,12,서귀포시,50130259,성산읍,남성+여성,15412,1660,17072,2020년 12월
2021,1,서귀포시,50130259,성산읍,남성+여성,15397,1656,17053,2021년 1월
2021,2,서귀포시,50130259,성산읍,남성+여성,15403,1650,17053,2021년 2월
2021,3,서귀포시,50130259,성산읍,남성+여성,15419,1627,17046,2021년 3월
2021,4,서귀포시,50130259,성산읍,남성+여성,15437,1562,16999,2021년 4월
2021,5,서귀포시,50130259,성산읍,남성+여성,15448,1525,16973,2021년 5월
2021,6,서귀포시,50130259,성산읍,남성+여성,15478,1494,16972,2021년 6월
2018,1,서귀포시,50130510,송산동,남성+여성,4455,523,4978,2018년 1월
2018,2,서귀포시,50130510,송산동,남성+여성,4466,529,4995,2018년 2월
2018,3,서귀포시,50130510,송산동,남성+여성,4462,526,4988,2018년 3월
2018,4,서귀포시,50130510,송산동,남성+여성,4453,513,4966,2018년 4월
2018,5,서귀포시,50130510,송산동,남성+여성,4425,524,4949,2018년 5월
2018,6,서귀포시,50130510,송산동,남성+여성,4420,531,4951,2018년 6월
2018,7,서귀포시,50130510,송산동,남성+여성,4409,549,4958,2018년 7월
2018,8,서귀포시,50130510,송산동,남성+여성,4408,565,4973,2018년 8월
2018,9,서귀포시,50130510,송산동,남성+여성,4404,599,5003,2018년 9월
2018,10,서귀포시,50130510,송산동,남성+여성,4412,600,5012,2018년 10월
2018,11,서귀포시,50130510,송산동,남성+여성,4418,608,5026,2018년 11월
2018,12,서귀포시,50130510,송산동,남성+여성,4417,610,5027,2018년 12월
2019,1,서귀포시,50130510,송산동,남성+여성,4383,596,4979,2019년 1월
2019,2,서귀포시,50130510,송산동,남성+여성,4369,597,4966,2019년 2월
2019,3,서귀포시,50130510,송산동,남성+여성,4335,585,4920,2019년 3월
2019,4,서귀포시,50130510,송산동,남성+여성,4334,581,4915,2019년 4월
2019,5,서귀포시,50130510,송산동,남성+여성,4321,575,4896,2019년 5월
2019,6,서귀포시,50130510,송산동,남성+여성,4312,589,4901,2019년 6월
2019,7,서귀포시,50130510,송산동,남성+여성,4287,598,4885,2019년 7월
2019,8,서귀포시,50130510,송산동,남성+여성,4291,606,4897,2019년 8월
2019,9,서귀포시,50130510,송산동,남성+여성,4274,602,4876,2019년 9월
2019,10,서귀포시,50130510,송산동,남성+여성,4269,605,4874,2019년 10월
2019,11,서귀포시,50130510,송산동,남성+여성,4262,606,4868,2019년 11월
2019,12,서귀포시,50130510,송산동,남성+여성,4286,607,4893,2019년 12월
2020,1,서귀포시,50130510,송산동,남성+여성,4265,606,4871,2020년 1월
2020,2,서귀포시,50130510,송산동,남성+여성,4263,605,4868,2020년 2월
2020,3,서귀포시,50130510,송산동,남성+여성,4245,596,4841,2020년 3월
2020,4,서귀포시,50130510,송산동,남성+여성,4223,590,4813,2020년 4월
2020,5,서귀포시,50130510,송산동,남성+여성,4195,583,4778,2020년 5월
2020,6,서귀포시,50130510,송산동,남성+여성,4198,580,4778,2020년 6월
2020,7,서귀포시,50130510,송산동,남성+여성,4169,558,4727,2020년 7월
2020,8,서귀포시,50130510,송산동,남성+여성,4205,519,4724,2020년 8월
2020,9,서귀포시,50130510,송산동,남성+여성,4202,519,4721,2020년 9월
2020,10,서귀포시,50130510,송산동,남성+여성,4174,491,4665,2020년 10월
2020,11,서귀포시,50130510,송산동,남성+여성,4175,483,4658,2020년 11월
2020,12,서귀포시,50130510,송산동,남성+여성,4171,487,4658,2020년 12월
2021,1,서귀포시,50130510,송산동,남성+여성,4145,478,4623,2021년 1월
2021,2,서귀포시,50130510,송산동,남성+여성,4117,466,4583,2021년 2월
2021,3,서귀포시,50130510,송산동,남성+여성,4061,462,4523,2021년 3월
2021,4,서귀포시,50130510,송산동,남성+여성,4061,457,4518,2021년 4월
2021,5,서귀포시,50130510,송산동,남성+여성,4043,462,4505,2021년 5월
2021,6,서귀포시,50130510,송산동,남성+여성,4044,466,4510,2021년 6월
2018,1,제주시,50110630,아라동,남성+여성,30472,995,31467,2018년 1월
2018,2,제주시,50110630,아라동,남성+여성,30993,980,31973,2018년 2월
2018,3,제주시,50110630,아라동,남성+여성,31460,1091,32551,2018년 3월
2018,4,제주시,50110630,아라동,남성+여성,31816,1065,32881,2018년 4월
2018,5,제주시,50110630,아라동,남성+여성,32026,1071,33097,2018년 5월
2018,6,제주시,50110630,아라동,남성+여성,32272,1069,33341,2018년 6월
2018,7,제주시,50110630,아라동,남성+여성,32583,1066,33649,2018년 7월
2018,8,제주시,50110630,아라동,남성+여성,32763,1048,33811,2018년 8월
2018,9,제주시,50110630,아라동,남성+여성,32886,1217,34103,2018년 9월
2018,10,제주시,50110630,아라동,남성+여성,32981,1230,34211,2018년 10월
2018,11,제주시,50110630,아라동,남성+여성,33087,1238,34325,2018년 11월
2018,12,제주시,50110630,아라동,남성+여성,33099,1222,34321,2018년 12월
2019,1,제주시,50110630,아라동,남성+여성,33347,1207,34554,2019년 1월
2019,2,제주시,50110630,아라동,남성+여성,33493,1174,34667,2019년 2월
2019,3,제주시,50110630,아라동,남성+여성,33566,1306,34872,2019년 3월
2019,4,제주시,50110630,아라동,남성+여성,33687,1276,34963,2019년 4월
2019,5,제주시,50110630,아라동,남성+여성,33799,1260,35059,2019년 5월
2019,6,제주시,50110630,아라동,남성+여성,33888,1245,35133,2019년 6월
2019,7,제주시,50110630,아라동,남성+여성,34037,1239,35276,2019년 7월
2019,8,제주시,50110630,아라동,남성+여성,34195,1232,35427,2019년 8월
2019,9,제주시,50110630,아라동,남성+여성,34357,1280,35637,2019년 9월
2019,10,제주시,50110630,아라동,남성+여성,34592,1262,35854,2019년 10월
2019,11,제주시,50110630,아라동,남성+여성,34727,1270,35997,2019년 11월
2019,12,제주시,50110630,아라동,남성+여성,34806,1218,36024,2019년 12월
2020,1,제주시,50110630,아라동,남성+여성,34879,1218,36097,2020년 1월
2020,2,제주시,50110630,아라동,남성+여성,34955,1186,36141,2020년 2월
2020,3,제주시,50110630,아라동,남성+여성,35008,1159,36167,2020년 3월
2020,4,제주시,50110630,아라동,남성+여성,35144,1083,36227,2020년 4월
2020,5,제주시,50110630,아라동,남성+여성,35281,1069,36350,2020년 5월
2020,6,제주시,50110630,아라동,남성+여성,35460,1061,36521,2020년 6월
2020,7,제주시,50110630,아라동,남성+여성,35511,1043,36554,2020년 7월
2020,8,제주시,50110630,아라동,남성+여성,35937,1017,36954,2020년 8월
2020,9,제주시,50110630,아라동,남성+여성,36590,1118,37708,2020년 9월
2020,10,제주시,50110630,아라동,남성+여성,36776,1093,37869,2020년 10월
2020,11,제주시,50110630,아라동,남성+여성,36912,1095,38007,2020년 11월
2020,12,제주시,50110630,아라동,남성+여성,37070,1067,38137,2020년 12월
2021,1,제주시,50110630,아라동,남성+여성,37416,1045,38461,2021년 1월
2021,2,제주시,50110630,아라동,남성+여성,37836,1013,38849,2021년 2월
2021,3,제주시,50110630,아라동,남성+여성,38072,1029,39101,2021년 3월
2021,4,제주시,50110630,아라동,남성+여성,38176,1037,39213,2021년 4월
2021,5,제주시,50110630,아라동,남성+여성,38243,1042,39285,2021년 5월
2021,6,제주시,50110630,아라동,남성+여성,38359,1037,39396,2021년 6월
2018,1,서귀포시,50130310,안덕면,남성+여성,11462,522,11984,2018년 1월
2018,2,서귀포시,50130310,안덕면,남성+여성,11545,533,12078,2018년 2월
2018,3,서귀포시,50130310,안덕면,남성+여성,11595,533,12128,2018년 3월
2018,4,서귀포시,50130310,안덕면,남성+여성,11677,549,12226,2018년 4월
2018,5,서귀포시,50130310,안덕면,남성+여성,11720,559,12279,2018년 5월
2018,6,서귀포시,50130310,안덕면,남성+여성,11715,592,12307,2018년 6월
2018,7,서귀포시,50130310,안덕면,남성+여성,11746,646,12392,2018년 7월
2018,8,서귀포시,50130310,안덕면,남성+여성,11803,670,12473,2018년 8월
2018,9,서귀포시,50130310,안덕면,남성+여성,11871,693,12564,2018년 9월
2018,10,서귀포시,50130310,안덕면,남성+여성,11871,693,12564,2018년 10월
2018,11,서귀포시,50130310,안덕면,남성+여성,11904,660,12564,2018년 11월
2018,12,서귀포시,50130310,안덕면,남성+여성,11867,670,12537,2018년 12월
2019,1,서귀포시,50130310,안덕면,남성+여성,11858,665,12523,2019년 1월
2019,2,서귀포시,50130310,안덕면,남성+여성,11835,674,12509,2019년 2월
2019,3,서귀포시,50130310,안덕면,남성+여성,11824,664,12488,2019년 3월
2019,4,서귀포시,50130310,안덕면,남성+여성,11839,692,12531,2019년 4월
2019,5,서귀포시,50130310,안덕면,남성+여성,11867,700,12567,2019년 5월
2019,6,서귀포시,50130310,안덕면,남성+여성,11888,725,12613,2019년 6월
2019,7,서귀포시,50130310,안덕면,남성+여성,11909,744,12653,2019년 7월
2019,8,서귀포시,50130310,안덕면,남성+여성,11952,746,12698,2019년 8월
2019,9,서귀포시,50130310,안덕면,남성+여성,11981,768,12749,2019년 9월
2019,10,서귀포시,50130310,안덕면,남성+여성,11967,735,12702,2019년 10월
2019,11,서귀포시,50130310,안덕면,남성+여성,11988,726,12714,2019년 11월
2019,12,서귀포시,50130310,안덕면,남성+여성,12023,688,12711,2019년 12월
2020,1,서귀포시,50130310,안덕면,남성+여성,12053,705,12758,2020년 1월
2020,2,서귀포시,50130310,안덕면,남성+여성,12044,694,12738,2020년 2월
2020,3,서귀포시,50130310,안덕면,남성+여성,12020,654,12674,2020년 3월
2020,4,서귀포시,50130310,안덕면,남성+여성,11980,642,12622,2020년 4월
2020,5,서귀포시,50130310,안덕면,남성+여성,11974,642,12616,2020년 5월
2020,6,서귀포시,50130310,안덕면,남성+여성,11940,609,12549,2020년 6월
2020,7,서귀포시,50130310,안덕면,남성+여성,11956,607,12563,2020년 7월
2020,8,서귀포시,50130310,안덕면,남성+여성,11986,580,12566,2020년 8월
2020,9,서귀포시,50130310,안덕면,남성+여성,12008,573,12581,2020년 9월
2020,10,서귀포시,50130310,안덕면,남성+여성,11965,548,12513,2020년 10월
2020,11,서귀포시,50130310,안덕면,남성+여성,11980,538,12518,2020년 11월
2020,12,서귀포시,50130310,안덕면,남성+여성,11982,541,12523,2020년 12월
2021,1,서귀포시,50130310,안덕면,남성+여성,12034,534,12568,2021년 1월
2021,2,서귀포시,50130310,안덕면,남성+여성,12049,529,12578,2021년 2월
2021,3,서귀포시,50130310,안덕면,남성+여성,12095,525,12620,2021년 3월
2021,4,서귀포시,50130310,안덕면,남성+여성,12121,519,12640,2021년 4월
2021,5,서귀포시,50130310,안덕면,남성+여성,12164,510,12674,2021년 5월
2021,6,서귀포시,50130310,안덕면,남성+여성,12205,509,12714,2021년 6월
2018,1,제주시,50110253,애월읍,남성+여성,34271,935,35206,2018년 1월
2018,2,제주시,50110253,애월읍,남성+여성,34386,1040,35426,2018년 2월
2018,3,제주시,50110253,애월읍,남성+여성,34491,1029,35520,2018년 3월
2018,4,제주시,50110253,애월읍,남성+여성,34628,1013,35641,2018년 4월
2018,5,제주시,50110253,애월읍,남성+여성,34705,1038,35743,2018년 5월
2018,6,제주시,50110253,애월읍,남성+여성,34831,1031,35862,2018년 6월
2018,7,제주시,50110253,애월읍,남성+여성,34943,1035,35978,2018년 7월
2018,8,제주시,50110253,애월읍,남성+여성,35045,1014,36059,2018년 8월
2018,9,제주시,50110253,애월읍,남성+여성,35140,1042,36182,2018년 9월
2018,10,제주시,50110253,애월읍,남성+여성,35300,1094,36394,2018년 10월
2018,11,제주시,50110253,애월읍,남성+여성,35402,1094,36496,2018년 11월
2018,12,제주시,50110253,애월읍,남성+여성,35451,1099,36550,2018년 12월
2019,1,제주시,50110253,애월읍,남성+여성,35478,1168,36646,2019년 1월
2019,2,제주시,50110253,애월읍,남성+여성,35590,1154,36744,2019년 2월
2019,3,제주시,50110253,애월읍,남성+여성,35734,1115,36849,2019년 3월
2019,4,제주시,50110253,애월읍,남성+여성,35796,1106,36902,2019년 4월
2019,5,제주시,50110253,애월읍,남성+여성,35918,1101,37019,2019년 5월
2019,6,제주시,50110253,애월읍,남성+여성,36046,1070,37116,2019년 6월
2019,7,제주시,50110253,애월읍,남성+여성,36051,1068,37119,2019년 7월
2019,8,제주시,50110253,애월읍,남성+여성,36056,1071,37127,2019년 8월
2019,9,제주시,50110253,애월읍,남성+여성,36110,1084,37194,2019년 9월
2019,10,제주시,50110253,애월읍,남성+여성,36132,1115,37247,2019년 10월
2019,11,제주시,50110253,애월읍,남성+여성,36182,1117,37299,2019년 11월
2019,12,제주시,50110253,애월읍,남성+여성,36233,1112,37345,2019년 12월
2020,1,제주시,50110253,애월읍,남성+여성,36186,1124,37310,2020년 1월
2020,2,제주시,50110253,애월읍,남성+여성,36333,1113,37446,2020년 2월
2020,3,제주시,50110253,애월읍,남성+여성,36359,1074,37433,2020년 3월
2020,4,제주시,50110253,애월읍,남성+여성,36396,1048,37444,2020년 4월
2020,5,제주시,50110253,애월읍,남성+여성,36516,1035,37551,2020년 5월
2020,6,제주시,50110253,애월읍,남성+여성,36616,1030,37646,2020년 6월
2020,7,제주시,50110253,애월읍,남성+여성,36705,1035,37740,2020년 7월
2020,8,제주시,50110253,애월읍,남성+여성,36815,1032,37847,2020년 8월
2020,9,제주시,50110253,애월읍,남성+여성,36810,978,37788,2020년 9월
2020,10,제주시,50110253,애월읍,남성+여성,36799,988,37787,2020년 10월
2020,11,제주시,50110253,애월읍,남성+여성,36842,989,37831,2020년 11월
2020,12,제주시,50110253,애월읍,남성+여성,36913,985,37898,2020년 12월
2021,1,제주시,50110253,애월읍,남성+여성,36936,968,37904,2021년 1월
2021,2,제주시,50110253,애월읍,남성+여성,37006,950,37956,2021년 2월
2021,3,제주시,50110253,애월읍,남성+여성,37072,943,38015,2021년 3월
2021,4,제주시,50110253,애월읍,남성+여성,37127,953,38080,2021년 4월
2021,5,제주시,50110253,애월읍,남성+여성,37223,974,38197,2021년 5월
2021,6,제주시,50110253,애월읍,남성+여성,37337,961,38298,2021년 6월
2018,1,제주시,50110650,연동,남성+여성,41609,1629,43238,2018년 1월
2018,2,제주시,50110650,연동,남성+여성,41488,1644,43132,2018년 2월
2018,3,제주시,50110650,연동,남성+여성,41434,1670,43104,2018년 3월
2018,4,제주시,50110650,연동,남성+여성,41427,1688,43115,2018년 4월
2018,5,제주시,50110650,연동,남성+여성,41458,1705,43163,2018년 5월
2018,6,제주시,50110650,연동,남성+여성,41409,1705,43114,2018년 6월
2018,7,제주시,50110650,연동,남성+여성,41462,1721,43183,2018년 7월
2018,8,제주시,50110650,연동,남성+여성,41510,1731,43241,2018년 8월
2018,9,제주시,50110650,연동,남성+여성,41493,1726,43219,2018년 9월
2018,10,제주시,50110650,연동,남성+여성,41448,1751,43199,2018년 10월
2018,11,제주시,50110650,연동,남성+여성,41443,1777,43220,2018년 11월
2018,12,제주시,50110650,연동,남성+여성,41397,1820,43217,2018년 12월
2019,1,제주시,50110650,연동,남성+여성,41418,1899,43317,2019년 1월
2019,2,제주시,50110650,연동,남성+여성,41362,1933,43295,2019년 2월
2019,3,제주시,50110650,연동,남성+여성,41428,2004,43432,2019년 3월
2019,4,제주시,50110650,연동,남성+여성,41459,1978,43437,2019년 4월
2019,5,제주시,50110650,연동,남성+여성,41503,1977,43480,2019년 5월
2019,6,제주시,50110650,연동,남성+여성,41479,2003,43482,2019년 6월
2019,7,제주시,50110650,연동,남성+여성,41513,2113,43626,2019년 7월
2019,8,제주시,50110650,연동,남성+여성,41522,2163,43685,2019년 8월
2019,9,제주시,50110650,연동,남성+여성,41522,2171,43693,2019년 9월
2019,10,제주시,50110650,연동,남성+여성,41465,2197,43662,2019년 10월
2019,11,제주시,50110650,연동,남성+여성,41474,2208,43682,2019년 11월
2019,12,제주시,50110650,연동,남성+여성,41513,2195,43708,2019년 12월
2020,1,제주시,50110650,연동,남성+여성,41487,2224,43711,2020년 1월
2020,2,제주시,50110650,연동,남성+여성,41486,2249,43735,2020년 2월
2020,3,제주시,50110650,연동,남성+여성,41435,2213,43648,2020년 3월
2020,4,제주시,50110650,연동,남성+여성,41500,2151,43651,2020년 4월
2020,5,제주시,50110650,연동,남성+여성,41528,2129,43657,2020년 5월
2020,6,제주시,50110650,연동,남성+여성,41660,2112,43772,2020년 6월
2020,7,제주시,50110650,연동,남성+여성,41744,2116,43860,2020년 7월
2020,8,제주시,50110650,연동,남성+여성,41678,2078,43756,2020년 8월
2020,9,제주시,50110650,연동,남성+여성,41714,2086,43800,2020년 9월
2020,10,제주시,50110650,연동,남성+여성,41796,2062,43858,2020년 10월
2020,11,제주시,50110650,연동,남성+여성,41801,2045,43846,2020년 11월
2020,12,제주시,50110650,연동,남성+여성,41910,2006,43916,2020년 12월
2021,1,제주시,50110650,연동,남성+여성,41908,1991,43899,2021년 1월
2021,2,제주시,50110650,연동,남성+여성,41926,1982,43908,2021년 2월
2021,3,제주시,50110650,연동,남성+여성,41949,1952,43901,2021년 3월
2021,4,제주시,50110650,연동,남성+여성,41949,1934,43883,2021년 4월
2021,5,제주시,50110650,연동,남성+여성,41953,1911,43864,2021년 5월
2021,6,제주시,50110650,연동,남성+여성,41910,1875,43785,2021년 6월
2018,1,서귀포시,50130560,영천동,남성+여성,5166,171,5337,2018년 1월
2018,2,서귀포시,50130560,영천동,남성+여성,5172,170,5342,2018년 2월
2018,3,서귀포시,50130560,영천동,남성+여성,5169,169,5338,2018년 3월
2018,4,서귀포시,50130560,영천동,남성+여성,5187,174,5361,2018년 4월
2018,5,서귀포시,50130560,영천동,남성+여성,5205,176,5381,2018년 5월
2018,6,서귀포시,50130560,영천동,남성+여성,5200,177,5377,2018년 6월
2018,7,서귀포시,50130560,영천동,남성+여성,5221,189,5410,2018년 7월
2018,8,서귀포시,50130560,영천동,남성+여성,5242,189,5431,2018년 8월
2018,9,서귀포시,50130560,영천동,남성+여성,5243,188,5431,2018년 9월
2018,10,서귀포시,50130560,영천동,남성+여성,5255,193,5448,2018년 10월
2018,11,서귀포시,50130560,영천동,남성+여성,5264,190,5454,2018년 11월
2018,12,서귀포시,50130560,영천동,남성+여성,5292,186,5478,2018년 12월
2019,1,서귀포시,50130560,영천동,남성+여성,5295,182,5477,2019년 1월
2019,2,서귀포시,50130560,영천동,남성+여성,5320,185,5505,2019년 2월
2019,3,서귀포시,50130560,영천동,남성+여성,5331,182,5513,2019년 3월
2019,4,서귀포시,50130560,영천동,남성+여성,5332,181,5513,2019년 4월
2019,5,서귀포시,50130560,영천동,남성+여성,5342,184,5526,2019년 5월
2019,6,서귀포시,50130560,영천동,남성+여성,5376,189,5565,2019년 6월
2019,7,서귀포시,50130560,영천동,남성+여성,5385,189,5574,2019년 7월
2019,8,서귀포시,50130560,영천동,남성+여성,5385,190,5575,2019년 8월
2019,9,서귀포시,50130560,영천동,남성+여성,5365,191,5556,2019년 9월
2019,10,서귀포시,50130560,영천동,남성+여성,5350,195,5545,2019년 10월
2019,11,서귀포시,50130560,영천동,남성+여성,5351,192,5543,2019년 11월
2019,12,서귀포시,50130560,영천동,남성+여성,5289,196,5485,2019년 12월
2020,1,서귀포시,50130560,영천동,남성+여성,5301,194,5495,2020년 1월
2020,2,서귀포시,50130560,영천동,남성+여성,5281,190,5471,2020년 2월
2020,3,서귀포시,50130560,영천동,남성+여성,5297,184,5481,2020년 3월
2020,4,서귀포시,50130560,영천동,남성+여성,5288,181,5469,2020년 4월
2020,5,서귀포시,50130560,영천동,남성+여성,5261,178,5439,2020년 5월
2020,6,서귀포시,50130560,영천동,남성+여성,5236,178,5414,2020년 6월
2020,7,서귀포시,50130560,영천동,남성+여성,5222,181,5403,2020년 7월
2020,8,서귀포시,50130560,영천동,남성+여성,5202,179,5381,2020년 8월
2020,9,서귀포시,50130560,영천동,남성+여성,5189,178,5367,2020년 9월
2020,10,서귀포시,50130560,영천동,남성+여성,5188,175,5363,2020년 10월
2020,11,서귀포시,50130560,영천동,남성+여성,5207,173,5380,2020년 11월
2020,12,서귀포시,50130560,영천동,남성+여성,5199,172,5371,2020년 12월
2021,1,서귀포시,50130560,영천동,남성+여성,5175,171,5346,2021년 1월
2021,2,서귀포시,50130560,영천동,남성+여성,5182,166,5348,2021년 2월
2021,3,서귀포시,50130560,영천동,남성+여성,5165,164,5329,2021년 3월
2021,4,서귀포시,50130560,영천동,남성+여성,5151,163,5314,2021년 4월
2021,5,서귀포시,50130560,영천동,남성+여성,5133,160,5293,2021년 5월
2021,6,서귀포시,50130560,영천동,남성+여성,5146,155,5301,2021년 6월
2018,1,서귀포시,50130620,예래동,남성+여성,3933,143,4076,2018년 1월
2018,2,서귀포시,50130620,예래동,남성+여성,3957,139,4096,2018년 2월
2018,3,서귀포시,50130620,예래동,남성+여성,3983,140,4123,2018년 3월
2018,4,서귀포시,50130620,예래동,남성+여성,4019,148,4167,2018년 4월
2018,5,서귀포시,50130620,예래동,남성+여성,4034,159,4193,2018년 5월
2018,6,서귀포시,50130620,예래동,남성+여성,4054,180,4234,2018년 6월
2018,7,서귀포시,50130620,예래동,남성+여성,4026,228,4254,2018년 7월
2018,8,서귀포시,50130620,예래동,남성+여성,4064,238,4302,2018년 8월
2018,9,서귀포시,50130620,예래동,남성+여성,4083,250,4333,2018년 9월
2018,10,서귀포시,50130620,예래동,남성+여성,4092,276,4368,2018년 10월
2018,11,서귀포시,50130620,예래동,남성+여성,4118,279,4397,2018년 11월
2018,12,서귀포시,50130620,예래동,남성+여성,4136,278,4414,2018년 12월
2019,1,서귀포시,50130620,예래동,남성+여성,4139,282,4421,2019년 1월
2019,2,서귀포시,50130620,예래동,남성+여성,4126,275,4401,2019년 2월
2019,3,서귀포시,50130620,예래동,남성+여성,4122,284,4406,2019년 3월
2019,4,서귀포시,50130620,예래동,남성+여성,4099,283,4382,2019년 4월
2019,5,서귀포시,50130620,예래동,남성+여성,4084,280,4364,2019년 5월
2019,6,서귀포시,50130620,예래동,남성+여성,4066,276,4342,2019년 6월
2019,7,서귀포시,50130620,예래동,남성+여성,4069,283,4352,2019년 7월
2019,8,서귀포시,50130620,예래동,남성+여성,4047,284,4331,2019년 8월
2019,9,서귀포시,50130620,예래동,남성+여성,4042,282,4324,2019년 9월
2019,10,서귀포시,50130620,예래동,남성+여성,4014,281,4295,2019년 10월
2019,11,서귀포시,50130620,예래동,남성+여성,3997,283,4280,2019년 11월
2019,12,서귀포시,50130620,예래동,남성+여성,3974,273,4247,2019년 12월
2020,1,서귀포시,50130620,예래동,남성+여성,3983,277,4260,2020년 1월
2020,2,서귀포시,50130620,예래동,남성+여성,3978,281,4259,2020년 2월
2020,3,서귀포시,50130620,예래동,남성+여성,3964,271,4235,2020년 3월
2020,4,서귀포시,50130620,예래동,남성+여성,3954,269,4223,2020년 4월
2020,5,서귀포시,50130620,예래동,남성+여성,3926,271,4197,2020년 5월
2020,6,서귀포시,50130620,예래동,남성+여성,3935,273,4208,2020년 6월
2020,7,서귀포시,50130620,예래동,남성+여성,3938,274,4212,2020년 7월
2020,8,서귀포시,50130620,예래동,남성+여성,3934,269,4203,2020년 8월
2020,9,서귀포시,50130620,예래동,남성+여성,3933,266,4199,2020년 9월
2020,10,서귀포시,50130620,예래동,남성+여성,3938,259,4197,2020년 10월
2020,11,서귀포시,50130620,예래동,남성+여성,3944,257,4201,2020년 11월
2020,12,서귀포시,50130620,예래동,남성+여성,3938,262,4200,2020년 12월
2021,1,서귀포시,50130620,예래동,남성+여성,3934,258,4192,2021년 1월
2021,2,서귀포시,50130620,예래동,남성+여성,3917,256,4173,2021년 2월
2021,3,서귀포시,50130620,예래동,남성+여성,3925,253,4178,2021년 3월
2021,4,서귀포시,50130620,예래동,남성+여성,3908,253,4161,2021년 4월
2021,5,서귀포시,50130620,예래동,남성+여성,3931,247,4178,2021년 5월
2021,6,서귀포시,50130620,예래동,남성+여성,3915,237,4152,2021년 6월
2018,1,제주시,50110640,오라동,남성+여성,13636,193,13829,2018년 1월
2018,2,제주시,50110640,오라동,남성+여성,13729,192,13921,2018년 2월
2018,3,제주시,50110640,오라동,남성+여성,13835,191,14026,2018년 3월
2018,4,제주시,50110640,오라동,남성+여성,13932,191,14123,2018년 4월
2018,5,제주시,50110640,오라동,남성+여성,13994,198,14192,2018년 5월
2018,6,제주시,50110640,오라동,남성+여성,14217,206,14423,2018년 6월
2018,7,제주시,50110640,오라동,남성+여성,14287,217,14504,2018년 7월
2018,8,제주시,50110640,오라동,남성+여성,14361,226,14587,2018년 8월
2018,9,제주시,50110640,오라동,남성+여성,14423,225,14648,2018년 9월
2018,10,제주시,50110640,오라동,남성+여성,14515,234,14749,2018년 10월
2018,11,제주시,50110640,오라동,남성+여성,14595,226,14821,2018년 11월
2018,12,제주시,50110640,오라동,남성+여성,14673,233,14906,2018년 12월
2019,1,제주시,50110640,오라동,남성+여성,14780,240,15020,2019년 1월
2019,2,제주시,50110640,오라동,남성+여성,14819,245,15064,2019년 2월
2019,3,제주시,50110640,오라동,남성+여성,14902,237,15139,2019년 3월
2019,4,제주시,50110640,오라동,남성+여성,15042,240,15282,2019년 4월
2019,5,제주시,50110640,오라동,남성+여성,15142,243,15385,2019년 5월
2019,6,제주시,50110640,오라동,남성+여성,15191,245,15436,2019년 6월
2019,7,제주시,50110640,오라동,남성+여성,15191,248,15439,2019년 7월
2019,8,제주시,50110640,오라동,남성+여성,15235,252,15487,2019년 8월
2019,9,제주시,50110640,오라동,남성+여성,15266,249,15515,2019년 9월
2019,10,제주시,50110640,오라동,남성+여성,15287,248,15535,2019년 10월
2019,11,제주시,50110640,오라동,남성+여성,15300,250,15550,2019년 11월
2019,12,제주시,50110640,오라동,남성+여성,15334,254,15588,2019년 12월
2020,1,제주시,50110640,오라동,남성+여성,15397,257,15654,2020년 1월
2020,2,제주시,50110640,오라동,남성+여성,15425,258,15683,2020년 2월
2020,3,제주시,50110640,오라동,남성+여성,15522,247,15769,2020년 3월
2020,4,제주시,50110640,오라동,남성+여성,15611,248,15859,2020년 4월
2020,5,제주시,50110640,오라동,남성+여성,15703,250,15953,2020년 5월
2020,6,제주시,50110640,오라동,남성+여성,15730,257,15987,2020년 6월
2020,7,제주시,50110640,오라동,남성+여성,15747,249,15996,2020년 7월
2020,8,제주시,50110640,오라동,남성+여성,15789,249,16038,2020년 8월
2020,9,제주시,50110640,오라동,남성+여성,15751,241,15992,2020년 9월
2020,10,제주시,50110640,오라동,남성+여성,15757,231,15988,2020년 10월
2020,11,제주시,50110640,오라동,남성+여성,15738,224,15962,2020년 11월
2020,12,제주시,50110640,오라동,남성+여성,15746,220,15966,2020년 12월
2021,1,제주시,50110640,오라동,남성+여성,15713,228,15941,2021년 1월
2021,2,제주시,50110640,오라동,남성+여성,15752,227,15979,2021년 2월
2021,3,제주시,50110640,오라동,남성+여성,15766,220,15986,2021년 3월
2021,4,제주시,50110640,오라동,남성+여성,15790,217,16007,2021년 4월
2021,5,제주시,50110640,오라동,남성+여성,15800,220,16020,2021년 5월
2021,6,제주시,50110640,오라동,남성+여성,15748,216,15964,2021년 6월
2018,1,제주시,50110670,외도동,남성+여성,20828,277,21105,2018년 1월
2018,2,제주시,50110670,외도동,남성+여성,20870,272,21142,2018년 2월
2018,3,제주시,50110670,외도동,남성+여성,20992,272,21264,2018년 3월
2018,4,제주시,50110670,외도동,남성+여성,21041,277,21318,2018년 4월
2018,5,제주시,50110670,외도동,남성+여성,21071,284,21355,2018년 5월
2018,6,제주시,50110670,외도동,남성+여성,21145,291,21436,2018년 6월
2018,7,제주시,50110670,외도동,남성+여성,21232,291,21523,2018년 7월
2018,8,제주시,50110670,외도동,남성+여성,21367,288,21655,2018년 8월
2018,9,제주시,50110670,외도동,남성+여성,21415,288,21703,2018년 9월
2018,10,제주시,50110670,외도동,남성+여성,21440,289,21729,2018년 10월
2018,11,제주시,50110670,외도동,남성+여성,21438,291,21729,2018년 11월
2018,12,제주시,50110670,외도동,남성+여성,21445,296,21741,2018년 12월
2019,1,제주시,50110670,외도동,남성+여성,21443,299,21742,2019년 1월
2019,2,제주시,50110670,외도동,남성+여성,21457,298,21755,2019년 2월
2019,3,제주시,50110670,외도동,남성+여성,21474,304,21778,2019년 3월
2019,4,제주시,50110670,외도동,남성+여성,21495,299,21794,2019년 4월
2019,5,제주시,50110670,외도동,남성+여성,21528,298,21826,2019년 5월
2019,6,제주시,50110670,외도동,남성+여성,21571,292,21863,2019년 6월
2019,7,제주시,50110670,외도동,남성+여성,21629,294,21923,2019년 7월
2019,8,제주시,50110670,외도동,남성+여성,21663,296,21959,2019년 8월
2019,9,제주시,50110670,외도동,남성+여성,21660,295,21955,2019년 9월
2019,10,제주시,50110670,외도동,남성+여성,21694,301,21995,2019년 10월
2019,11,제주시,50110670,외도동,남성+여성,21720,300,22020,2019년 11월
2019,12,제주시,50110670,외도동,남성+여성,21801,307,22108,2019년 12월
2020,1,제주시,50110670,외도동,남성+여성,21742,316,22058,2020년 1월
2020,2,제주시,50110670,외도동,남성+여성,21757,309,22066,2020년 2월
2020,3,제주시,50110670,외도동,남성+여성,21773,303,22076,2020년 3월
2020,4,제주시,50110670,외도동,남성+여성,21805,305,22110,2020년 4월
2020,5,제주시,50110670,외도동,남성+여성,21866,301,22167,2020년 5월
2020,6,제주시,50110670,외도동,남성+여성,21862,302,22164,2020년 6월
2020,7,제주시,50110670,외도동,남성+여성,21936,297,22233,2020년 7월
2020,8,제주시,50110670,외도동,남성+여성,21927,297,22224,2020년 8월
2020,9,제주시,50110670,외도동,남성+여성,21941,302,22243,2020년 9월
2020,10,제주시,50110670,외도동,남성+여성,21957,298,22255,2020년 10월
2020,11,제주시,50110670,외도동,남성+여성,22014,299,22313,2020년 11월
2020,12,제주시,50110670,외도동,남성+여성,22055,298,22353,2020년 12월
2021,1,제주시,50110670,외도동,남성+여성,22091,292,22383,2021년 1월
2021,2,제주시,50110670,외도동,남성+여성,22058,287,22345,2021년 2월
2021,3,제주시,50110670,외도동,남성+여성,22003,287,22290,2021년 3월
2021,4,제주시,50110670,외도동,남성+여성,21982,271,22253,2021년 4월
2021,5,제주시,50110670,외도동,남성+여성,22031,276,22307,2021년 5월
2021,6,제주시,50110670,외도동,남성+여성,22086,274,22360,2021년 6월
2018,1,제주시,50110570,용담1동,남성+여성,7801,86,7887,2018년 1월
2018,2,제주시,50110570,용담1동,남성+여성,7752,84,7836,2018년 2월
2018,3,제주시,50110570,용담1동,남성+여성,7742,85,7827,2018년 3월
2018,4,제주시,50110570,용담1동,남성+여성,7717,84,7801,2018년 4월
2018,5,제주시,50110570,용담1동,남성+여성,7702,86,7788,2018년 5월
2018,6,제주시,50110570,용담1동,남성+여성,7653,84,7737,2018년 6월
2018,7,제주시,50110570,용담1동,남성+여성,7616,87,7703,2018년 7월
2018,8,제주시,50110570,용담1동,남성+여성,7595,86,7681,2018년 8월
2018,9,제주시,50110570,용담1동,남성+여성,7582,81,7663,2018년 9월
2018,10,제주시,50110570,용담1동,남성+여성,7576,85,7661,2018년 10월
2018,11,제주시,50110570,용담1동,남성+여성,7562,83,7645,2018년 11월
2018,12,제주시,50110570,용담1동,남성+여성,7527,83,7610,2018년 12월
2019,1,제주시,50110570,용담1동,남성+여성,7479,84,7563,2019년 1월
2019,2,제주시,50110570,용담1동,남성+여성,7427,85,7512,2019년 2월
2019,3,제주시,50110570,용담1동,남성+여성,7414,86,7500,2019년 3월
2019,4,제주시,50110570,용담1동,남성+여성,7396,92,7488,2019년 4월
2019,5,제주시,50110570,용담1동,남성+여성,7360,88,7448,2019년 5월
2019,6,제주시,50110570,용담1동,남성+여성,7338,85,7423,2019년 6월
2019,7,제주시,50110570,용담1동,남성+여성,7334,85,7419,2019년 7월
2019,8,제주시,50110570,용담1동,남성+여성,7321,85,7406,2019년 8월
2019,9,제주시,50110570,용담1동,남성+여성,7307,91,7398,2019년 9월
2019,10,제주시,50110570,용담1동,남성+여성,7294,94,7388,2019년 10월
2019,11,제주시,50110570,용담1동,남성+여성,7250,95,7345,2019년 11월
2019,12,제주시,50110570,용담1동,남성+여성,7225,90,7315,2019년 12월
2020,1,제주시,50110570,용담1동,남성+여성,7261,92,7353,2020년 1월
2020,2,제주시,50110570,용담1동,남성+여성,7241,97,7338,2020년 2월
2020,3,제주시,50110570,용담1동,남성+여성,7226,92,7318,2020년 3월
2020,4,제주시,50110570,용담1동,남성+여성,7213,91,7304,2020년 4월
2020,5,제주시,50110570,용담1동,남성+여성,7203,90,7293,2020년 5월
2020,6,제주시,50110570,용담1동,남성+여성,7174,89,7263,2020년 6월
2020,7,제주시,50110570,용담1동,남성+여성,7176,89,7265,2020년 7월
2020,8,제주시,50110570,용담1동,남성+여성,7159,92,7251,2020년 8월
2020,9,제주시,50110570,용담1동,남성+여성,7096,94,7190,2020년 9월
2020,10,제주시,50110570,용담1동,남성+여성,7083,92,7175,2020년 10월
2020,11,제주시,50110570,용담1동,남성+여성,7072,91,7163,2020년 11월
2020,12,제주시,50110570,용담1동,남성+여성,7050,90,7140,2020년 12월
2021,1,제주시,50110570,용담1동,남성+여성,6991,87,7078,2021년 1월
2021,2,제주시,50110570,용담1동,남성+여성,6993,87,7080,2021년 2월
2021,3,제주시,50110570,용담1동,남성+여성,6939,85,7024,2021년 3월
2021,4,제주시,50110570,용담1동,남성+여성,6962,85,7047,2021년 4월
2021,5,제주시,50110570,용담1동,남성+여성,6953,84,7037,2021년 5월
2021,6,제주시,50110570,용담1동,남성+여성,6937,88,7025,2021년 6월
2018,1,제주시,50110580,용담2동,남성+여성,15713,203,15916,2018년 1월
2018,2,제주시,50110580,용담2동,남성+여성,15638,205,15843,2018년 2월
2018,3,제주시,50110580,용담2동,남성+여성,15585,206,15791,2018년 3월
2018,4,제주시,50110580,용담2동,남성+여성,15590,223,15813,2018년 4월
2018,5,제주시,50110580,용담2동,남성+여성,15607,226,15833,2018년 5월
2018,6,제주시,50110580,용담2동,남성+여성,15567,235,15802,2018년 6월
2018,7,제주시,50110580,용담2동,남성+여성,15561,245,15806,2018년 7월
2018,8,제주시,50110580,용담2동,남성+여성,15542,241,15783,2018년 8월
2018,9,제주시,50110580,용담2동,남성+여성,15525,247,15772,2018년 9월
2018,10,제주시,50110580,용담2동,남성+여성,15527,247,15774,2018년 10월
2018,11,제주시,50110580,용담2동,남성+여성,15449,248,15697,2018년 11월
2018,12,제주시,50110580,용담2동,남성+여성,15426,247,15673,2018년 12월
2019,1,제주시,50110580,용담2동,남성+여성,15360,260,15620,2019년 1월
2019,2,제주시,50110580,용담2동,남성+여성,15345,261,15606,2019년 2월
2019,3,제주시,50110580,용담2동,남성+여성,15303,262,15565,2019년 3월
2019,4,제주시,50110580,용담2동,남성+여성,15278,265,15543,2019년 4월
2019,5,제주시,50110580,용담2동,남성+여성,15277,266,15543,2019년 5월
2019,6,제주시,50110580,용담2동,남성+여성,15260,263,15523,2019년 6월
2019,7,제주시,50110580,용담2동,남성+여성,15255,258,15513,2019년 7월
2019,8,제주시,50110580,용담2동,남성+여성,15238,259,15497,2019년 8월
2019,9,제주시,50110580,용담2동,남성+여성,15196,258,15454,2019년 9월
2019,10,제주시,50110580,용담2동,남성+여성,15124,263,15387,2019년 10월
2019,11,제주시,50110580,용담2동,남성+여성,15084,259,15343,2019년 11월
2019,12,제주시,50110580,용담2동,남성+여성,15074,254,15328,2019년 12월
2020,1,제주시,50110580,용담2동,남성+여성,15051,258,15309,2020년 1월
2020,2,제주시,50110580,용담2동,남성+여성,15051,253,15304,2020년 2월
2020,3,제주시,50110580,용담2동,남성+여성,15037,252,15289,2020년 3월
2020,4,제주시,50110580,용담2동,남성+여성,15010,248,15258,2020년 4월
2020,5,제주시,50110580,용담2동,남성+여성,14992,236,15228,2020년 5월
2020,6,제주시,50110580,용담2동,남성+여성,14970,234,15204,2020년 6월
2020,7,제주시,50110580,용담2동,남성+여성,14961,227,15188,2020년 7월
2020,8,제주시,50110580,용담2동,남성+여성,14925,223,15148,2020년 8월
2020,9,제주시,50110580,용담2동,남성+여성,14852,223,15075,2020년 9월
2020,10,제주시,50110580,용담2동,남성+여성,14820,215,15035,2020년 10월
2020,11,제주시,50110580,용담2동,남성+여성,14792,218,15010,2020년 11월
2020,12,제주시,50110580,용담2동,남성+여성,14798,216,15014,2020년 12월
2021,1,제주시,50110580,용담2동,남성+여성,14749,208,14957,2021년 1월
2021,2,제주시,50110580,용담2동,남성+여성,14702,209,14911,2021년 2월
2021,3,제주시,50110580,용담2동,남성+여성,14626,204,14830,2021년 3월
2021,4,제주시,50110580,용담2동,남성+여성,14625,206,14831,2021년 4월
2021,5,제주시,50110580,용담2동,남성+여성,14593,203,14796,2021년 5월
2021,6,제주시,50110580,용담2동,남성+여성,14575,197,14772,2021년 6월
2018,1,제주시,50110330,우도면,남성+여성,1856,32,1888,2018년 1월
2018,2,제주시,50110330,우도면,남성+여성,1857,32,1889,2018년 2월
2018,3,제주시,50110330,우도면,남성+여성,1865,32,1897,2018년 3월
2018,4,제주시,50110330,우도면,남성+여성,1873,34,1907,2018년 4월
2018,5,제주시,50110330,우도면,남성+여성,1878,33,1911,2018년 5월
2018,6,제주시,50110330,우도면,남성+여성,1885,34,1919,2018년 6월
2018,7,제주시,50110330,우도면,남성+여성,1888,35,1923,2018년 7월
2018,8,제주시,50110330,우도면,남성+여성,1879,36,1915,2018년 8월
2018,9,제주시,50110330,우도면,남성+여성,1880,38,1918,2018년 9월
2018,10,제주시,50110330,우도면,남성+여성,1870,40,1910,2018년 10월
2018,11,제주시,50110330,우도면,남성+여성,1867,40,1907,2018년 11월
2018,12,제주시,50110330,우도면,남성+여성,1852,40,1892,2018년 12월
2019,1,제주시,50110330,우도면,남성+여성,1855,39,1894,2019년 1월
2019,2,제주시,50110330,우도면,남성+여성,1861,37,1898,2019년 2월
2019,3,제주시,50110330,우도면,남성+여성,1855,37,1892,2019년 3월
2019,4,제주시,50110330,우도면,남성+여성,1867,38,1905,2019년 4월
2019,5,제주시,50110330,우도면,남성+여성,1876,36,1912,2019년 5월
2019,6,제주시,50110330,우도면,남성+여성,1869,37,1906,2019년 6월
2019,7,제주시,50110330,우도면,남성+여성,1871,34,1905,2019년 7월
2019,8,제주시,50110330,우도면,남성+여성,1889,35,1924,2019년 8월
2019,9,제주시,50110330,우도면,남성+여성,1883,32,1915,2019년 9월
2019,10,제주시,50110330,우도면,남성+여성,1882,33,1915,2019년 10월
2019,11,제주시,50110330,우도면,남성+여성,1862,32,1894,2019년 11월
2019,12,제주시,50110330,우도면,남성+여성,1862,30,1892,2019년 12월
2020,1,제주시,50110330,우도면,남성+여성,1860,30,1890,2020년 1월
2020,2,제주시,50110330,우도면,남성+여성,1843,29,1872,2020년 2월
2020,3,제주시,50110330,우도면,남성+여성,1828,26,1854,2020년 3월
2020,4,제주시,50110330,우도면,남성+여성,1812,26,1838,2020년 4월
2020,5,제주시,50110330,우도면,남성+여성,1792,26,1818,2020년 5월
2020,6,제주시,50110330,우도면,남성+여성,1781,24,1805,2020년 6월
2020,7,제주시,50110330,우도면,남성+여성,1778,24,1802,2020년 7월
2020,8,제주시,50110330,우도면,남성+여성,1768,24,1792,2020년 8월
2020,9,제주시,50110330,우도면,남성+여성,1752,24,1776,2020년 9월
2020,10,제주시,50110330,우도면,남성+여성,1750,23,1773,2020년 10월
2020,11,제주시,50110330,우도면,남성+여성,1753,23,1776,2020년 11월
2020,12,제주시,50110330,우도면,남성+여성,1740,26,1766,2020년 12월
2021,1,제주시,50110330,우도면,남성+여성,1741,26,1767,2021년 1월
2021,2,제주시,50110330,우도면,남성+여성,1746,26,1772,2021년 2월
2021,3,제주시,50110330,우도면,남성+여성,1734,27,1761,2021년 3월
2021,4,제주시,50110330,우도면,남성+여성,1722,27,1749,2021년 4월
2021,5,제주시,50110330,우도면,남성+여성,1719,27,1746,2021년 5월
2021,6,제주시,50110330,우도면,남성+여성,1722,29,1751,2021년 6월
2018,1,제주시,50110530,이도1동,남성+여성,7955,132,8087,2018년 1월
2018,2,제주시,50110530,이도1동,남성+여성,7926,124,8050,2018년 2월
2018,3,제주시,50110530,이도1동,남성+여성,7928,123,8051,2018년 3월
2018,4,제주시,50110530,이도1동,남성+여성,7917,117,8034,2018년 4월
2018,5,제주시,50110530,이도1동,남성+여성,7907,118,8025,2018년 5월
2018,6,제주시,50110530,이도1동,남성+여성,7880,121,8001,2018년 6월
2018,7,제주시,50110530,이도1동,남성+여성,7875,125,8000,2018년 7월
2018,8,제주시,50110530,이도1동,남성+여성,7883,126,8009,2018년 8월
2018,9,제주시,50110530,이도1동,남성+여성,7872,128,8000,2018년 9월
2018,10,제주시,50110530,이도1동,남성+여성,7862,132,7994,2018년 10월
2018,11,제주시,50110530,이도1동,남성+여성,7865,137,8002,2018년 11월
2018,12,제주시,50110530,이도1동,남성+여성,7851,138,7989,2018년 12월
2019,1,제주시,50110530,이도1동,남성+여성,7824,141,7965,2019년 1월
2019,2,제주시,50110530,이도1동,남성+여성,7821,139,7960,2019년 2월
2019,3,제주시,50110530,이도1동,남성+여성,7761,138,7899,2019년 3월
2019,4,제주시,50110530,이도1동,남성+여성,7716,139,7855,2019년 4월
2019,5,제주시,50110530,이도1동,남성+여성,7703,137,7840,2019년 5월
2019,6,제주시,50110530,이도1동,남성+여성,7694,138,7832,2019년 6월
2019,7,제주시,50110530,이도1동,남성+여성,7690,144,7834,2019년 7월
2019,8,제주시,50110530,이도1동,남성+여성,7655,144,7799,2019년 8월
2019,9,제주시,50110530,이도1동,남성+여성,7660,155,7815,2019년 9월
2019,10,제주시,50110530,이도1동,남성+여성,7656,149,7805,2019년 10월
2019,11,제주시,50110530,이도1동,남성+여성,7617,142,7759,2019년 11월
2019,12,제주시,50110530,이도1동,남성+여성,7649,147,7796,2019년 12월
2020,1,제주시,50110530,이도1동,남성+여성,7688,146,7834,2020년 1월
2020,2,제주시,50110530,이도1동,남성+여성,7702,143,7845,2020년 2월
2020,3,제주시,50110530,이도1동,남성+여성,7691,134,7825,2020년 3월
2020,4,제주시,50110530,이도1동,남성+여성,7686,136,7822,2020년 4월
2020,5,제주시,50110530,이도1동,남성+여성,7676,135,7811,2020년 5월
2020,6,제주시,50110530,이도1동,남성+여성,7670,136,7806,2020년 6월
2020,7,제주시,50110530,이도1동,남성+여성,7664,134,7798,2020년 7월
2020,8,제주시,50110530,이도1동,남성+여성,7645,130,7775,2020년 8월
2020,9,제주시,50110530,이도1동,남성+여성,7680,131,7811,2020년 9월
2020,10,제주시,50110530,이도1동,남성+여성,7674,125,7799,2020년 10월
2020,11,제주시,50110530,이도1동,남성+여성,7670,125,7795,2020년 11월
2020,12,제주시,50110530,이도1동,남성+여성,7683,125,7808,2020년 12월
2021,1,제주시,50110530,이도1동,남성+여성,7635,123,7758,2021년 1월
2021,2,제주시,50110530,이도1동,남성+여성,7572,125,7697,2021년 2월
2021,3,제주시,50110530,이도1동,남성+여성,7534,127,7661,2021년 3월
2021,4,제주시,50110530,이도1동,남성+여성,7541,129,7670,2021년 4월
2021,5,제주시,50110530,이도1동,남성+여성,7509,127,7636,2021년 5월
2021,6,제주시,50110530,이도1동,남성+여성,7537,130,7667,2021년 6월
2018,1,제주시,50110540,이도2동,남성+여성,50103,558,50661,2018년 1월
2018,2,제주시,50110540,이도2동,남성+여성,49905,548,50453,2018년 2월
2018,3,제주시,50110540,이도2동,남성+여성,49821,567,50388,2018년 3월
2018,4,제주시,50110540,이도2동,남성+여성,49813,572,50385,2018년 4월
2018,5,제주시,50110540,이도2동,남성+여성,49883,694,50577,2018년 5월
2018,6,제주시,50110540,이도2동,남성+여성,49914,663,50577,2018년 6월
2018,7,제주시,50110540,이도2동,남성+여성,49828,654,50482,2018년 7월
2018,8,제주시,50110540,이도2동,남성+여성,49817,647,50464,2018년 8월
2018,9,제주시,50110540,이도2동,남성+여성,49784,671,50455,2018년 9월
2018,10,제주시,50110540,이도2동,남성+여성,49732,684,50416,2018년 10월
2018,11,제주시,50110540,이도2동,남성+여성,49672,660,50332,2018년 11월
2018,12,제주시,50110540,이도2동,남성+여성,49456,681,50137,2018년 12월
2019,1,제주시,50110540,이도2동,남성+여성,49649,679,50328,2019년 1월
2019,2,제주시,50110540,이도2동,남성+여성,49716,681,50397,2019년 2월
2019,3,제주시,50110540,이도2동,남성+여성,49769,687,50456,2019년 3월
2019,4,제주시,50110540,이도2동,남성+여성,49851,675,50526,2019년 4월
2019,5,제주시,50110540,이도2동,남성+여성,49945,667,50612,2019년 5월
2019,6,제주시,50110540,이도2동,남성+여성,49982,673,50655,2019년 6월
2019,7,제주시,50110540,이도2동,남성+여성,50038,658,50696,2019년 7월
2019,8,제주시,50110540,이도2동,남성+여성,50060,674,50734,2019년 8월
2019,9,제주시,50110540,이도2동,남성+여성,50088,676,50764,2019년 9월
2019,10,제주시,50110540,이도2동,남성+여성,50081,686,50767,2019년 10월
2019,11,제주시,50110540,이도2동,남성+여성,50038,683,50721,2019년 11월
2019,12,제주시,50110540,이도2동,남성+여성,49964,691,50655,2019년 12월
2020,1,제주시,50110540,이도2동,남성+여성,49953,692,50645,2020년 1월
2020,2,제주시,50110540,이도2동,남성+여성,49942,700,50642,2020년 2월
2020,3,제주시,50110540,이도2동,남성+여성,50011,683,50694,2020년 3월
2020,4,제주시,50110540,이도2동,남성+여성,50040,676,50716,2020년 4월
2020,5,제주시,50110540,이도2동,남성+여성,50074,666,50740,2020년 5월
2020,6,제주시,50110540,이도2동,남성+여성,50115,667,50782,2020년 6월
2020,7,제주시,50110540,이도2동,남성+여성,50136,649,50785,2020년 7월
2020,8,제주시,50110540,이도2동,남성+여성,50112,634,50746,2020년 8월
2020,9,제주시,50110540,이도2동,남성+여성,49986,623,50609,2020년 9월
2020,10,제주시,50110540,이도2동,남성+여성,50006,614,50620,2020년 10월
2020,11,제주시,50110540,이도2동,남성+여성,49947,602,50549,2020년 11월
2020,12,제주시,50110540,이도2동,남성+여성,49834,589,50423,2020년 12월
2021,1,제주시,50110540,이도2동,남성+여성,49801,581,50382,2021년 1월
2021,2,제주시,50110540,이도2동,남성+여성,49638,577,50215,2021년 2월
2021,3,제주시,50110540,이도2동,남성+여성,49541,578,50119,2021년 3월
2021,4,제주시,50110540,이도2동,남성+여성,49555,578,50133,2021년 4월
2021,5,제주시,50110540,이도2동,남성+여성,49559,575,50134,2021년 5월
2021,6,제주시,50110540,이도2동,남성+여성,49553,563,50116,2021년 6월
2018,1,제주시,50110680,이호동,남성+여성,4168,137,4305,2018년 1월
2018,2,제주시,50110680,이호동,남성+여성,4177,139,4316,2018년 2월
2018,3,제주시,50110680,이호동,남성+여성,4258,144,4402,2018년 3월
2018,4,제주시,50110680,이호동,남성+여성,4291,139,4430,2018년 4월
2018,5,제주시,50110680,이호동,남성+여성,4320,139,4459,2018년 5월
2018,6,제주시,50110680,이호동,남성+여성,4354,147,4501,2018년 6월
2018,7,제주시,50110680,이호동,남성+여성,4395,144,4539,2018년 7월
2018,8,제주시,50110680,이호동,남성+여성,4444,146,4590,2018년 8월
2018,9,제주시,50110680,이호동,남성+여성,4485,153,4638,2018년 9월
2018,10,제주시,50110680,이호동,남성+여성,4464,156,4620,2018년 10월
2018,11,제주시,50110680,이호동,남성+여성,4469,160,4629,2018년 11월
2018,12,제주시,50110680,이호동,남성+여성,4495,159,4654,2018년 12월
2019,1,제주시,50110680,이호동,남성+여성,4524,159,4683,2019년 1월
2019,2,제주시,50110680,이호동,남성+여성,4519,160,4679,2019년 2월
2019,3,제주시,50110680,이호동,남성+여성,4537,161,4698,2019년 3월
2019,4,제주시,50110680,이호동,남성+여성,4551,164,4715,2019년 4월
2019,5,제주시,50110680,이호동,남성+여성,4569,168,4737,2019년 5월
2019,6,제주시,50110680,이호동,남성+여성,4556,168,4724,2019년 6월
2019,7,제주시,50110680,이호동,남성+여성,4569,168,4737,2019년 7월
2019,8,제주시,50110680,이호동,남성+여성,4576,175,4751,2019년 8월
2019,9,제주시,50110680,이호동,남성+여성,4545,175,4720,2019년 9월
2019,10,제주시,50110680,이호동,남성+여성,4572,177,4749,2019년 10월
2019,11,제주시,50110680,이호동,남성+여성,4547,184,4731,2019년 11월
2019,12,제주시,50110680,이호동,남성+여성,4569,195,4764,2019년 12월
2020,1,제주시,50110680,이호동,남성+여성,4573,197,4770,2020년 1월
2020,2,제주시,50110680,이호동,남성+여성,4553,193,4746,2020년 2월
2020,3,제주시,50110680,이호동,남성+여성,4560,192,4752,2020년 3월
2020,4,제주시,50110680,이호동,남성+여성,4576,191,4767,2020년 4월
2020,5,제주시,50110680,이호동,남성+여성,4583,184,4767,2020년 5월
2020,6,제주시,50110680,이호동,남성+여성,4602,187,4789,2020년 6월
2020,7,제주시,50110680,이호동,남성+여성,4597,183,4780,2020년 7월
2020,8,제주시,50110680,이호동,남성+여성,4580,185,4765,2020년 8월
2020,9,제주시,50110680,이호동,남성+여성,4591,185,4776,2020년 9월
2020,10,제주시,50110680,이호동,남성+여성,4596,184,4780,2020년 10월
2020,11,제주시,50110680,이호동,남성+여성,4573,185,4758,2020년 11월
2020,12,제주시,50110680,이호동,남성+여성,4572,174,4746,2020년 12월
2021,1,제주시,50110680,이호동,남성+여성,4564,176,4740,2021년 1월
2021,2,제주시,50110680,이호동,남성+여성,4554,169,4723,2021년 2월
2021,3,제주시,50110680,이호동,남성+여성,4563,167,4730,2021년 3월
2021,4,제주시,50110680,이호동,남성+여성,4568,164,4732,2021년 4월
2021,5,제주시,50110680,이호동,남성+여성,4534,158,4692,2021년 5월
2021,6,제주시,50110680,이호동,남성+여성,4520,155,4675,2021년 6월
2018,1,제주시,50110510,일도1동,남성+여성,3039,88,3127,2018년 1월
2018,2,제주시,50110510,일도1동,남성+여성,2995,89,3084,2018년 2월
2018,3,제주시,50110510,일도1동,남성+여성,2977,86,3063,2018년 3월
2018,4,제주시,50110510,일도1동,남성+여성,2983,86,3069,2018년 4월
2018,5,제주시,50110510,일도1동,남성+여성,2985,96,3081,2018년 5월
2018,6,제주시,50110510,일도1동,남성+여성,2976,96,3072,2018년 6월
2018,7,제주시,50110510,일도1동,남성+여성,2958,115,3073,2018년 7월
2018,8,제주시,50110510,일도1동,남성+여성,2959,113,3072,2018년 8월
2018,9,제주시,50110510,일도1동,남성+여성,2938,108,3046,2018년 9월
2018,10,제주시,50110510,일도1동,남성+여성,2925,112,3037,2018년 10월
2018,11,제주시,50110510,일도1동,남성+여성,2906,113,3019,2018년 11월
2018,12,제주시,50110510,일도1동,남성+여성,2884,109,2993,2018년 12월
2019,1,제주시,50110510,일도1동,남성+여성,2870,104,2974,2019년 1월
2019,2,제주시,50110510,일도1동,남성+여성,2873,97,2970,2019년 2월
2019,3,제주시,50110510,일도1동,남성+여성,2870,98,2968,2019년 3월
2019,4,제주시,50110510,일도1동,남성+여성,2849,96,2945,2019년 4월
2019,5,제주시,50110510,일도1동,남성+여성,2832,96,2928,2019년 5월
2019,6,제주시,50110510,일도1동,남성+여성,2817,96,2913,2019년 6월
2019,7,제주시,50110510,일도1동,남성+여성,2804,93,2897,2019년 7월
2019,8,제주시,50110510,일도1동,남성+여성,2774,90,2864,2019년 8월
2019,9,제주시,50110510,일도1동,남성+여성,2775,93,2868,2019년 9월
2019,10,제주시,50110510,일도1동,남성+여성,2747,90,2837,2019년 10월
2019,11,제주시,50110510,일도1동,남성+여성,2731,88,2819,2019년 11월
2019,12,제주시,50110510,일도1동,남성+여성,2724,85,2809,2019년 12월
2020,1,제주시,50110510,일도1동,남성+여성,2701,84,2785,2020년 1월
2020,2,제주시,50110510,일도1동,남성+여성,2671,81,2752,2020년 2월
2020,3,제주시,50110510,일도1동,남성+여성,2676,77,2753,2020년 3월
2020,4,제주시,50110510,일도1동,남성+여성,2675,77,2752,2020년 4월
2020,5,제주시,50110510,일도1동,남성+여성,2665,79,2744,2020년 5월
2020,6,제주시,50110510,일도1동,남성+여성,2669,74,2743,2020년 6월
2020,7,제주시,50110510,일도1동,남성+여성,2655,78,2733,2020년 7월
2020,8,제주시,50110510,일도1동,남성+여성,2640,79,2719,2020년 8월
2020,9,제주시,50110510,일도1동,남성+여성,2633,78,2711,2020년 9월
2020,10,제주시,50110510,일도1동,남성+여성,2615,79,2694,2020년 10월
2020,11,제주시,50110510,일도1동,남성+여성,2613,82,2695,2020년 11월
2020,12,제주시,50110510,일도1동,남성+여성,2584,80,2664,2020년 12월
2021,1,제주시,50110510,일도1동,남성+여성,2561,79,2640,2021년 1월
2021,2,제주시,50110510,일도1동,남성+여성,2544,81,2625,2021년 2월
2021,3,제주시,50110510,일도1동,남성+여성,2485,80,2565,2021년 3월
2021,4,제주시,50110510,일도1동,남성+여성,2464,80,2544,2021년 4월
2021,5,제주시,50110510,일도1동,남성+여성,2454,79,2533,2021년 5월
2021,6,제주시,50110510,일도1동,남성+여성,2465,77,2542,2021년 6월
2018,1,제주시,50110520,일도2동,남성+여성,34985,276,35261,2018년 1월
2018,2,제주시,50110520,일도2동,남성+여성,34953,278,35231,2018년 2월
2018,3,제주시,50110520,일도2동,남성+여성,34960,274,35234,2018년 3월
2018,4,제주시,50110520,일도2동,남성+여성,34937,276,35213,2018년 4월
2018,5,제주시,50110520,일도2동,남성+여성,34872,269,35141,2018년 5월
2018,6,제주시,50110520,일도2동,남성+여성,34782,279,35061,2018년 6월
2018,7,제주시,50110520,일도2동,남성+여성,34684,289,34973,2018년 7월
2018,8,제주시,50110520,일도2동,남성+여성,34697,302,34999,2018년 8월
2018,9,제주시,50110520,일도2동,남성+여성,34662,313,34975,2018년 9월
2018,10,제주시,50110520,일도2동,남성+여성,34653,310,34963,2018년 10월
2018,11,제주시,50110520,일도2동,남성+여성,34586,299,34885,2018년 11월
2018,12,제주시,50110520,일도2동,남성+여성,34388,296,34684,2018년 12월
2019,1,제주시,50110520,일도2동,남성+여성,34190,308,34498,2019년 1월
2019,2,제주시,50110520,일도2동,남성+여성,34120,302,34422,2019년 2월
2019,3,제주시,50110520,일도2동,남성+여성,34074,294,34368,2019년 3월
2019,4,제주시,50110520,일도2동,남성+여성,34032,308,34340,2019년 4월
2019,5,제주시,50110520,일도2동,남성+여성,34002,310,34312,2019년 5월
2019,6,제주시,50110520,일도2동,남성+여성,33982,301,34283,2019년 6월
2019,7,제주시,50110520,일도2동,남성+여성,33965,308,34273,2019년 7월
2019,8,제주시,50110520,일도2동,남성+여성,33878,315,34193,2019년 8월
2019,9,제주시,50110520,일도2동,남성+여성,33885,323,34208,2019년 9월
2019,10,제주시,50110520,일도2동,남성+여성,33856,321,34177,2019년 10월
2019,11,제주시,50110520,일도2동,남성+여성,33791,323,34114,2019년 11월
2019,12,제주시,50110520,일도2동,남성+여성,33683,315,33998,2019년 12월
2020,1,제주시,50110520,일도2동,남성+여성,33612,314,33926,2020년 1월
2020,2,제주시,50110520,일도2동,남성+여성,33578,314,33892,2020년 2월
2020,3,제주시,50110520,일도2동,남성+여성,33493,313,33806,2020년 3월
2020,4,제주시,50110520,일도2동,남성+여성,33405,312,33717,2020년 4월
2020,5,제주시,50110520,일도2동,남성+여성,33362,314,33676,2020년 5월
2020,6,제주시,50110520,일도2동,남성+여성,33333,319,33652,2020년 6월
2020,7,제주시,50110520,일도2동,남성+여성,33300,316,33616,2020년 7월
2020,8,제주시,50110520,일도2동,남성+여성,33232,316,33548,2020년 8월
2020,9,제주시,50110520,일도2동,남성+여성,33192,316,33508,2020년 9월
2020,10,제주시,50110520,일도2동,남성+여성,33188,305,33493,2020년 10월
2020,11,제주시,50110520,일도2동,남성+여성,33118,295,33413,2020년 11월
2020,12,제주시,50110520,일도2동,남성+여성,33062,291,33353,2020년 12월
2021,1,제주시,50110520,일도2동,남성+여성,32888,287,33175,2021년 1월
2021,2,제주시,50110520,일도2동,남성+여성,32890,282,33172,2021년 2월
2021,3,제주시,50110520,일도2동,남성+여성,32714,279,32993,2021년 3월
2021,4,제주시,50110520,일도2동,남성+여성,32678,282,32960,2021년 4월
2021,5,제주시,50110520,일도2동,남성+여성,32671,277,32948,2021년 5월
2021,6,제주시,50110520,일도2동,남성+여성,32646,275,32921,2021년 6월
2018,1,서귀포시,50130520,정방동,남성+여성,2461,96,2557,2018년 1월
2018,2,서귀포시,50130520,정방동,남성+여성,2442,101,2543,2018년 2월
2018,3,서귀포시,50130520,정방동,남성+여성,2425,105,2530,2018년 3월
2018,4,서귀포시,50130520,정방동,남성+여성,2417,105,2522,2018년 4월
2018,5,서귀포시,50130520,정방동,남성+여성,2430,106,2536,2018년 5월
2018,6,서귀포시,50130520,정방동,남성+여성,2419,106,2525,2018년 6월
2018,7,서귀포시,50130520,정방동,남성+여성,2395,109,2504,2018년 7월
2018,8,서귀포시,50130520,정방동,남성+여성,2378,110,2488,2018년 8월
2018,9,서귀포시,50130520,정방동,남성+여성,2356,111,2467,2018년 9월
2018,10,서귀포시,50130520,정방동,남성+여성,2347,109,2456,2018년 10월
2018,11,서귀포시,50130520,정방동,남성+여성,2332,112,2444,2018년 11월
2018,12,서귀포시,50130520,정방동,남성+여성,2333,111,2444,2018년 12월
2019,1,서귀포시,50130520,정방동,남성+여성,2346,112,2458,2019년 1월
2019,2,서귀포시,50130520,정방동,남성+여성,2321,120,2441,2019년 2월
2019,3,서귀포시,50130520,정방동,남성+여성,2328,115,2443,2019년 3월
2019,4,서귀포시,50130520,정방동,남성+여성,2321,115,2436,2019년 4월
2019,5,서귀포시,50130520,정방동,남성+여성,2330,113,2443,2019년 5월
2019,6,서귀포시,50130520,정방동,남성+여성,2334,114,2448,2019년 6월
2019,7,서귀포시,50130520,정방동,남성+여성,2324,115,2439,2019년 7월
2019,8,서귀포시,50130520,정방동,남성+여성,2304,120,2424,2019년 8월
2019,9,서귀포시,50130520,정방동,남성+여성,2284,122,2406,2019년 9월
2019,10,서귀포시,50130520,정방동,남성+여성,2294,125,2419,2019년 10월
2019,11,서귀포시,50130520,정방동,남성+여성,2289,128,2417,2019년 11월
2019,12,서귀포시,50130520,정방동,남성+여성,2276,123,2399,2019년 12월
2020,1,서귀포시,50130520,정방동,남성+여성,2258,123,2381,2020년 1월
2020,2,서귀포시,50130520,정방동,남성+여성,2259,126,2385,2020년 2월
2020,3,서귀포시,50130520,정방동,남성+여성,2243,123,2366,2020년 3월
2020,4,서귀포시,50130520,정방동,남성+여성,2238,124,2362,2020년 4월
2020,5,서귀포시,50130520,정방동,남성+여성,2231,121,2352,2020년 5월
2020,6,서귀포시,50130520,정방동,남성+여성,2245,119,2364,2020년 6월
2020,7,서귀포시,50130520,정방동,남성+여성,2238,120,2358,2020년 7월
2020,8,서귀포시,50130520,정방동,남성+여성,2217,120,2337,2020년 8월
2020,9,서귀포시,50130520,정방동,남성+여성,2217,119,2336,2020년 9월
2020,10,서귀포시,50130520,정방동,남성+여성,2211,119,2330,2020년 10월
2020,11,서귀포시,50130520,정방동,남성+여성,2203,119,2322,2020년 11월
2020,12,서귀포시,50130520,정방동,남성+여성,2196,119,2315,2020년 12월
2021,1,서귀포시,50130520,정방동,남성+여성,2184,118,2302,2021년 1월
2021,2,서귀포시,50130520,정방동,남성+여성,2157,120,2277,2021년 2월
2021,3,서귀포시,50130520,정방동,남성+여성,2122,117,2239,2021년 3월
2021,4,서귀포시,50130520,정방동,남성+여성,2126,114,2240,2021년 4월
2021,5,서귀포시,50130520,정방동,남성+여성,2136,113,2249,2021년 5월
2021,6,서귀포시,50130520,정방동,남성+여성,2132,112,2244,2021년 6월
2018,1,제주시,50110259,조천읍,남성+여성,23456,526,23982,2018년 1월
2018,2,제주시,50110259,조천읍,남성+여성,23511,520,24031,2018년 2월
2018,3,제주시,50110259,조천읍,남성+여성,23583,528,24111,2018년 3월
2018,4,제주시,50110259,조천읍,남성+여성,23659,538,24197,2018년 4월
2018,5,제주시,50110259,조천읍,남성+여성,23718,558,24276,2018년 5월
2018,6,제주시,50110259,조천읍,남성+여성,23780,570,24350,2018년 6월
2018,7,제주시,50110259,조천읍,남성+여성,23888,592,24480,2018년 7월
2018,8,제주시,50110259,조천읍,남성+여성,23926,603,24529,2018년 8월
2018,9,제주시,50110259,조천읍,남성+여성,23997,597,24594,2018년 9월
2018,10,제주시,50110259,조천읍,남성+여성,24026,599,24625,2018년 10월
2018,11,제주시,50110259,조천읍,남성+여성,24088,594,24682,2018년 11월
2018,12,제주시,50110259,조천읍,남성+여성,24106,612,24718,2018년 12월
2019,1,제주시,50110259,조천읍,남성+여성,24124,620,24744,2019년 1월
2019,2,제주시,50110259,조천읍,남성+여성,24228,614,24842,2019년 2월
2019,3,제주시,50110259,조천읍,남성+여성,24312,608,24920,2019년 3월
2019,4,제주시,50110259,조천읍,남성+여성,24346,603,24949,2019년 4월
2019,5,제주시,50110259,조천읍,남성+여성,24378,597,24975,2019년 5월
2019,6,제주시,50110259,조천읍,남성+여성,24417,593,25010,2019년 6월
2019,7,제주시,50110259,조천읍,남성+여성,24468,595,25063,2019년 7월
2019,8,제주시,50110259,조천읍,남성+여성,24456,587,25043,2019년 8월
2019,9,제주시,50110259,조천읍,남성+여성,24531,583,25114,2019년 9월
2019,10,제주시,50110259,조천읍,남성+여성,24568,587,25155,2019년 10월
2019,11,제주시,50110259,조천읍,남성+여성,24614,624,25238,2019년 11월
2019,12,제주시,50110259,조천읍,남성+여성,24670,643,25313,2019년 12월
2020,1,제주시,50110259,조천읍,남성+여성,24803,651,25454,2020년 1월
2020,2,제주시,50110259,조천읍,남성+여성,24937,652,25589,2020년 2월
2020,3,제주시,50110259,조천읍,남성+여성,24964,644,25608,2020년 3월
2020,4,제주시,50110259,조천읍,남성+여성,24995,651,25646,2020년 4월
2020,5,제주시,50110259,조천읍,남성+여성,24976,599,25575,2020년 5월
2020,6,제주시,50110259,조천읍,남성+여성,25058,586,25644,2020년 6월
2020,7,제주시,50110259,조천읍,남성+여성,25149,583,25732,2020년 7월
2020,8,제주시,50110259,조천읍,남성+여성,25168,574,25742,2020년 8월
2020,9,제주시,50110259,조천읍,남성+여성,25246,569,25815,2020년 9월
2020,10,제주시,50110259,조천읍,남성+여성,25295,568,25863,2020년 10월
2020,11,제주시,50110259,조천읍,남성+여성,25328,575,25903,2020년 11월
2020,12,제주시,50110259,조천읍,남성+여성,25339,566,25905,2020년 12월
2021,1,제주시,50110259,조천읍,남성+여성,25361,558,25919,2021년 1월
2021,2,제주시,50110259,조천읍,남성+여성,25407,545,25952,2021년 2월
2021,3,제주시,50110259,조천읍,남성+여성,25324,534,25858,2021년 3월
2021,4,제주시,50110259,조천읍,남성+여성,25380,526,25906,2021년 4월
2021,5,제주시,50110259,조천읍,남성+여성,25427,523,25950,2021년 5월
2021,6,제주시,50110259,조천읍,남성+여성,25439,521,25960,2021년 6월
2018,1,서귀포시,50130610,중문동,남성+여성,10696,279,10975,2018년 1월
2018,2,서귀포시,50130610,중문동,남성+여성,10754,282,11036,2018년 2월
2018,3,서귀포시,50130610,중문동,남성+여성,10805,280,11085,2018년 3월
2018,4,서귀포시,50130610,중문동,남성+여성,10873,272,11145,2018년 4월
2018,5,서귀포시,50130610,중문동,남성+여성,10916,277,11193,2018년 5월
2018,6,서귀포시,50130610,중문동,남성+여성,10984,291,11275,2018년 6월
2018,7,서귀포시,50130610,중문동,남성+여성,11075,294,11369,2018년 7월
2018,8,서귀포시,50130610,중문동,남성+여성,11096,301,11397,2018년 8월
2018,9,서귀포시,50130610,중문동,남성+여성,11138,308,11446,2018년 9월
2018,10,서귀포시,50130610,중문동,남성+여성,11125,312,11437,2018년 10월
2018,11,서귀포시,50130610,중문동,남성+여성,11134,322,11456,2018년 11월
2018,12,서귀포시,50130610,중문동,남성+여성,11159,323,11482,2018년 12월
2019,1,서귀포시,50130610,중문동,남성+여성,11146,324,11470,2019년 1월
2019,2,서귀포시,50130610,중문동,남성+여성,11127,326,11453,2019년 2월
2019,3,서귀포시,50130610,중문동,남성+여성,11141,332,11473,2019년 3월
2019,4,서귀포시,50130610,중문동,남성+여성,11166,333,11499,2019년 4월
2019,5,서귀포시,50130610,중문동,남성+여성,11220,335,11555,2019년 5월
2019,6,서귀포시,50130610,중문동,남성+여성,11244,339,11583,2019년 6월
2019,7,서귀포시,50130610,중문동,남성+여성,11279,330,11609,2019년 7월
2019,8,서귀포시,50130610,중문동,남성+여성,11261,333,11594,2019년 8월
2019,9,서귀포시,50130610,중문동,남성+여성,11240,339,11579,2019년 9월
2019,10,서귀포시,50130610,중문동,남성+여성,11233,334,11567,2019년 10월
2019,11,서귀포시,50130610,중문동,남성+여성,11294,329,11623,2019년 11월
2019,12,서귀포시,50130610,중문동,남성+여성,11337,328,11665,2019년 12월
2020,1,서귀포시,50130610,중문동,남성+여성,11365,328,11693,2020년 1월
2020,2,서귀포시,50130610,중문동,남성+여성,11371,326,11697,2020년 2월
2020,3,서귀포시,50130610,중문동,남성+여성,11376,325,11701,2020년 3월
2020,4,서귀포시,50130610,중문동,남성+여성,11390,323,11713,2020년 4월
2020,5,서귀포시,50130610,중문동,남성+여성,11471,309,11780,2020년 5월
2020,6,서귀포시,50130610,중문동,남성+여성,11515,309,11824,2020년 6월
2020,7,서귀포시,50130610,중문동,남성+여성,11533,308,11841,2020년 7월
2020,8,서귀포시,50130610,중문동,남성+여성,11567,312,11879,2020년 8월
2020,9,서귀포시,50130610,중문동,남성+여성,11589,306,11895,2020년 9월
2020,10,서귀포시,50130610,중문동,남성+여성,11554,304,11858,2020년 10월
2020,11,서귀포시,50130610,중문동,남성+여성,11551,297,11848,2020년 11월
2020,12,서귀포시,50130610,중문동,남성+여성,11586,291,11877,2020년 12월
2021,1,서귀포시,50130610,중문동,남성+여성,11543,287,11830,2021년 1월
2021,2,서귀포시,50130610,중문동,남성+여성,11539,290,11829,2021년 2월
2021,3,서귀포시,50130610,중문동,남성+여성,11544,290,11834,2021년 3월
2021,4,서귀포시,50130610,중문동,남성+여성,11573,303,11876,2021년 4월
2021,5,서귀포시,50130610,중문동,남성+여성,11556,309,11865,2021년 5월
2021,6,서귀포시,50130610,중문동,남성+여성,11563,305,11868,2021년 6월
2018,1,서귀포시,50130530,중앙동,남성+여성,3999,107,4106,2018년 1월
2018,2,서귀포시,50130530,중앙동,남성+여성,3959,111,4070,2018년 2월
2018,3,서귀포시,50130530,중앙동,남성+여성,3935,111,4046,2018년 3월
2018,4,서귀포시,50130530,중앙동,남성+여성,3939,109,4048,2018년 4월
2018,5,서귀포시,50130530,중앙동,남성+여성,3940,104,4044,2018년 5월
2018,6,서귀포시,50130530,중앙동,남성+여성,3940,104,4044,2018년 6월
2018,7,서귀포시,50130530,중앙동,남성+여성,3941,105,4046,2018년 7월
2018,8,서귀포시,50130530,중앙동,남성+여성,3913,107,4020,2018년 8월
2018,9,서귀포시,50130530,중앙동,남성+여성,3924,108,4032,2018년 9월
2018,10,서귀포시,50130530,중앙동,남성+여성,3919,105,4024,2018년 10월
2018,11,서귀포시,50130530,중앙동,남성+여성,3901,106,4007,2018년 11월
2018,12,서귀포시,50130530,중앙동,남성+여성,3879,105,3984,2018년 12월
2019,1,서귀포시,50130530,중앙동,남성+여성,3847,104,3951,2019년 1월
2019,2,서귀포시,50130530,중앙동,남성+여성,3848,101,3949,2019년 2월
2019,3,서귀포시,50130530,중앙동,남성+여성,3843,101,3944,2019년 3월
2019,4,서귀포시,50130530,중앙동,남성+여성,3845,102,3947,2019년 4월
2019,5,서귀포시,50130530,중앙동,남성+여성,3811,105,3916,2019년 5월
2019,6,서귀포시,50130530,중앙동,남성+여성,3805,100,3905,2019년 6월
2019,7,서귀포시,50130530,중앙동,남성+여성,3802,100,3902,2019년 7월
2019,8,서귀포시,50130530,중앙동,남성+여성,3778,103,3881,2019년 8월
2019,9,서귀포시,50130530,중앙동,남성+여성,3749,102,3851,2019년 9월
2019,10,서귀포시,50130530,중앙동,남성+여성,3747,103,3850,2019년 10월
2019,11,서귀포시,50130530,중앙동,남성+여성,3725,97,3822,2019년 11월
2019,12,서귀포시,50130530,중앙동,남성+여성,3705,93,3798,2019년 12월
2020,1,서귀포시,50130530,중앙동,남성+여성,3676,94,3770,2020년 1월
2020,2,서귀포시,50130530,중앙동,남성+여성,3662,98,3760,2020년 2월
2020,3,서귀포시,50130530,중앙동,남성+여성,3634,96,3730,2020년 3월
2020,4,서귀포시,50130530,중앙동,남성+여성,3634,93,3727,2020년 4월
2020,5,서귀포시,50130530,중앙동,남성+여성,3641,89,3730,2020년 5월
2020,6,서귀포시,50130530,중앙동,남성+여성,3624,86,3710,2020년 6월
2020,7,서귀포시,50130530,중앙동,남성+여성,3608,83,3691,2020년 7월
2020,8,서귀포시,50130530,중앙동,남성+여성,3595,81,3676,2020년 8월
2020,9,서귀포시,50130530,중앙동,남성+여성,3584,81,3665,2020년 9월
2020,10,서귀포시,50130530,중앙동,남성+여성,3563,79,3642,2020년 10월
2020,11,서귀포시,50130530,중앙동,남성+여성,3533,77,3610,2020년 11월
2020,12,서귀포시,50130530,중앙동,남성+여성,3519,73,3592,2020년 12월
2021,1,서귀포시,50130530,중앙동,남성+여성,3503,73,3576,2021년 1월
2021,2,서귀포시,50130530,중앙동,남성+여성,3467,71,3538,2021년 2월
2021,3,서귀포시,50130530,중앙동,남성+여성,3405,71,3476,2021년 3월
2021,4,서귀포시,50130530,중앙동,남성+여성,3383,73,3456,2021년 4월
2021,5,서귀포시,50130530,중앙동,남성+여성,3372,73,3445,2021년 5월
2021,6,서귀포시,50130530,중앙동,남성+여성,3358,72,3430,2021년 6월
2018,1,서귀포시,50130540,천지동,남성+여성,3547,96,3643,2018년 1월
2018,2,서귀포시,50130540,천지동,남성+여성,3537,97,3634,2018년 2월
2018,3,서귀포시,50130540,천지동,남성+여성,3532,97,3629,2018년 3월
2018,4,서귀포시,50130540,천지동,남성+여성,3530,96,3626,2018년 4월
2018,5,서귀포시,50130540,천지동,남성+여성,3567,104,3671,2018년 5월
2018,6,서귀포시,50130540,천지동,남성+여성,3560,105,3665,2018년 6월
2018,7,서귀포시,50130540,천지동,남성+여성,3556,109,3665,2018년 7월
2018,8,서귀포시,50130540,천지동,남성+여성,3566,110,3676,2018년 8월
2018,9,서귀포시,50130540,천지동,남성+여성,3561,119,3680,2018년 9월
2018,10,서귀포시,50130540,천지동,남성+여성,3570,112,3682,2018년 10월
2018,11,서귀포시,50130540,천지동,남성+여성,3564,115,3679,2018년 11월
2018,12,서귀포시,50130540,천지동,남성+여성,3570,118,3688,2018년 12월
2019,1,서귀포시,50130540,천지동,남성+여성,3550,119,3669,2019년 1월
2019,2,서귀포시,50130540,천지동,남성+여성,3569,118,3687,2019년 2월
2019,3,서귀포시,50130540,천지동,남성+여성,3589,117,3706,2019년 3월
2019,4,서귀포시,50130540,천지동,남성+여성,3621,117,3738,2019년 4월
2019,5,서귀포시,50130540,천지동,남성+여성,3615,115,3730,2019년 5월
2019,6,서귀포시,50130540,천지동,남성+여성,3600,121,3721,2019년 6월
2019,7,서귀포시,50130540,천지동,남성+여성,3600,119,3719,2019년 7월
2019,8,서귀포시,50130540,천지동,남성+여성,3580,120,3700,2019년 8월
2019,9,서귀포시,50130540,천지동,남성+여성,3560,117,3677,2019년 9월
2019,10,서귀포시,50130540,천지동,남성+여성,3559,119,3678,2019년 10월
2019,11,서귀포시,50130540,천지동,남성+여성,3548,117,3665,2019년 11월
2019,12,서귀포시,50130540,천지동,남성+여성,3544,112,3656,2019년 12월
2020,1,서귀포시,50130540,천지동,남성+여성,3558,111,3669,2020년 1월
2020,2,서귀포시,50130540,천지동,남성+여성,3535,110,3645,2020년 2월
2020,3,서귀포시,50130540,천지동,남성+여성,3546,106,3652,2020년 3월
2020,4,서귀포시,50130540,천지동,남성+여성,3545,107,3652,2020년 4월
2020,5,서귀포시,50130540,천지동,남성+여성,3556,105,3661,2020년 5월
2020,6,서귀포시,50130540,천지동,남성+여성,3568,106,3674,2020년 6월
2020,7,서귀포시,50130540,천지동,남성+여성,3558,108,3666,2020년 7월
2020,8,서귀포시,50130540,천지동,남성+여성,3561,108,3669,2020년 8월
2020,9,서귀포시,50130540,천지동,남성+여성,3539,106,3645,2020년 9월
2020,10,서귀포시,50130540,천지동,남성+여성,3526,110,3636,2020년 10월
2020,11,서귀포시,50130540,천지동,남성+여성,3523,110,3633,2020년 11월
2020,12,서귀포시,50130540,천지동,남성+여성,3524,112,3636,2020년 12월
2021,1,서귀포시,50130540,천지동,남성+여성,3515,110,3625,2021년 1월
2021,2,서귀포시,50130540,천지동,남성+여성,3503,109,3612,2021년 2월
2021,3,서귀포시,50130540,천지동,남성+여성,3463,108,3571,2021년 3월
2021,4,서귀포시,50130540,천지동,남성+여성,3453,109,3562,2021년 4월
2021,5,서귀포시,50130540,천지동,남성+여성,3477,114,3591,2021년 5월
2021,6,서귀포시,50130540,천지동,남성+여성,3466,115,3581,2021년 6월
2018,1,제주시,50110320,추자면,남성+여성,1862,363,2225,2018년 1월
2018,2,제주시,50110320,추자면,남성+여성,1885,359,2244,2018년 2월
2018,3,제주시,50110320,추자면,남성+여성,1858,350,2208,2018년 3월
2018,4,제주시,50110320,추자면,남성+여성,1845,344,2189,2018년 4월
2018,5,제주시,50110320,추자면,남성+여성,1825,335,2160,2018년 5월
2018,6,제주시,50110320,추자면,남성+여성,1832,344,2176,2018년 6월
2018,7,제주시,50110320,추자면,남성+여성,1821,340,2161,2018년 7월
2018,8,제주시,50110320,추자면,남성+여성,1823,347,2170,2018년 8월
2018,9,제주시,50110320,추자면,남성+여성,1816,351,2167,2018년 9월
2018,10,제주시,50110320,추자면,남성+여성,1810,342,2152,2018년 10월
2018,11,제주시,50110320,추자면,남성+여성,1799,344,2143,2018년 11월
2018,12,제주시,50110320,추자면,남성+여성,1804,345,2149,2018년 12월
2019,1,제주시,50110320,추자면,남성+여성,1789,335,2124,2019년 1월
2019,2,제주시,50110320,추자면,남성+여성,1764,333,2097,2019년 2월
2019,3,제주시,50110320,추자면,남성+여성,1756,325,2081,2019년 3월
2019,4,제주시,50110320,추자면,남성+여성,1759,317,2076,2019년 4월
2019,5,제주시,50110320,추자면,남성+여성,1750,318,2068,2019년 5월
2019,6,제주시,50110320,추자면,남성+여성,1741,328,2069,2019년 6월
2019,7,제주시,50110320,추자면,남성+여성,1738,327,2065,2019년 7월
2019,8,제주시,50110320,추자면,남성+여성,1737,325,2062,2019년 8월
2019,9,제주시,50110320,추자면,남성+여성,1743,336,2079,2019년 9월
2019,10,제주시,50110320,추자면,남성+여성,1732,335,2067,2019년 10월
2019,11,제주시,50110320,추자면,남성+여성,1735,346,2081,2019년 11월
2019,12,제주시,50110320,추자면,남성+여성,1733,324,2057,2019년 12월
2020,1,제주시,50110320,추자면,남성+여성,1717,327,2044,2020년 1월
2020,2,제주시,50110320,추자면,남성+여성,1729,316,2045,2020년 2월
2020,3,제주시,50110320,추자면,남성+여성,1704,304,2008,2020년 3월
2020,4,제주시,50110320,추자면,남성+여성,1698,296,1994,2020년 4월
2020,5,제주시,50110320,추자면,남성+여성,1696,292,1988,2020년 5월
2020,6,제주시,50110320,추자면,남성+여성,1687,292,1979,2020년 6월
2020,7,제주시,50110320,추자면,남성+여성,1682,284,1966,2020년 7월
2020,8,제주시,50110320,추자면,남성+여성,1681,277,1958,2020년 8월
2020,9,제주시,50110320,추자면,남성+여성,1674,276,1950,2020년 9월
2020,10,제주시,50110320,추자면,남성+여성,1669,278,1947,2020년 10월
2020,11,제주시,50110320,추자면,남성+여성,1671,276,1947,2020년 11월
2020,12,제주시,50110320,추자면,남성+여성,1677,286,1963,2020년 12월
2021,1,제주시,50110320,추자면,남성+여성,1663,273,1936,2021년 1월
2021,2,제주시,50110320,추자면,남성+여성,1653,267,1920,2021년 2월
2021,3,제주시,50110320,추자면,남성+여성,1636,265,1901,2021년 3월
2021,4,제주시,50110320,추자면,남성+여성,1632,262,1894,2021년 4월
2021,5,제주시,50110320,추자면,남성+여성,1623,255,1878,2021년 5월
2021,6,제주시,50110320,추자면,남성+여성,1626,251,1877,2021년 6월
2018,1,서귀포시,50130320,표선면,남성+여성,12253,409,12662,2018년 1월
2018,2,서귀포시,50130320,표선면,남성+여성,12284,399,12683,2018년 2월
2018,3,서귀포시,50130320,표선면,남성+여성,12278,403,12681,2018년 3월
2018,4,서귀포시,50130320,표선면,남성+여성,12313,403,12716,2018년 4월
2018,5,서귀포시,50130320,표선면,남성+여성,12321,414,12735,2018년 5월
2018,6,서귀포시,50130320,표선면,남성+여성,12333,420,12753,2018년 6월
2018,7,서귀포시,50130320,표선면,남성+여성,12378,422,12800,2018년 7월
2018,8,서귀포시,50130320,표선면,남성+여성,12361,425,12786,2018년 8월
2018,9,서귀포시,50130320,표선면,남성+여성,12377,422,12799,2018년 9월
2018,10,서귀포시,50130320,표선면,남성+여성,12421,435,12856,2018년 10월
2018,11,서귀포시,50130320,표선면,남성+여성,12389,447,12836,2018년 11월
2018,12,서귀포시,50130320,표선면,남성+여성,12374,450,12824,2018년 12월
2019,1,서귀포시,50130320,표선면,남성+여성,12334,443,12777,2019년 1월
2019,2,서귀포시,50130320,표선면,남성+여성,12322,444,12766,2019년 2월
2019,3,서귀포시,50130320,표선면,남성+여성,12328,441,12769,2019년 3월
2019,4,서귀포시,50130320,표선면,남성+여성,12347,434,12781,2019년 4월
2019,5,서귀포시,50130320,표선면,남성+여성,12365,432,12797,2019년 5월
2019,6,서귀포시,50130320,표선면,남성+여성,12378,430,12808,2019년 6월
2019,7,서귀포시,50130320,표선면,남성+여성,12369,430,12799,2019년 7월
2019,8,서귀포시,50130320,표선면,남성+여성,12335,428,12763,2019년 8월
2019,9,서귀포시,50130320,표선면,남성+여성,12330,445,12775,2019년 9월
2019,10,서귀포시,50130320,표선면,남성+여성,12309,444,12753,2019년 10월
2019,11,서귀포시,50130320,표선면,남성+여성,12318,443,12761,2019년 11월
2019,12,서귀포시,50130320,표선면,남성+여성,12284,438,12722,2019년 12월
2020,1,서귀포시,50130320,표선면,남성+여성,12248,437,12685,2020년 1월
2020,2,서귀포시,50130320,표선면,남성+여성,12252,437,12689,2020년 2월
2020,3,서귀포시,50130320,표선면,남성+여성,12263,424,12687,2020년 3월
2020,4,서귀포시,50130320,표선면,남성+여성,12286,420,12706,2020년 4월
2020,5,서귀포시,50130320,표선면,남성+여성,12277,400,12677,2020년 5월
2020,6,서귀포시,50130320,표선면,남성+여성,12276,395,12671,2020년 6월
2020,7,서귀포시,50130320,표선면,남성+여성,12290,391,12681,2020년 7월
2020,8,서귀포시,50130320,표선면,남성+여성,12310,385,12695,2020년 8월
2020,9,서귀포시,50130320,표선면,남성+여성,12346,381,12727,2020년 9월
2020,10,서귀포시,50130320,표선면,남성+여성,12344,378,12722,2020년 10월
2020,11,서귀포시,50130320,표선면,남성+여성,12334,373,12707,2020년 11월
2020,12,서귀포시,50130320,표선면,남성+여성,12325,366,12691,2020년 12월
2021,1,서귀포시,50130320,표선면,남성+여성,12339,361,12700,2021년 1월
2021,2,서귀포시,50130320,표선면,남성+여성,12357,362,12719,2021년 2월
2021,3,서귀포시,50130320,표선면,남성+여성,12307,356,12663,2021년 3월
2021,4,서귀포시,50130320,표선면,남성+여성,12334,350,12684,2021년 4월
2021,5,서귀포시,50130320,표선면,남성+여성,12337,339,12676,2021년 5월
2021,6,서귀포시,50130320,표선면,남성+여성,12347,334,12681,2021년 6월
2018,1,제주시,50110310,한경면,남성+여성,8950,319,9269,2018년 1월
2018,2,제주시,50110310,한경면,남성+여성,8965,311,9276,2018년 2월
2018,3,제주시,50110310,한경면,남성+여성,8999,308,9307,2018년 3월
2018,4,제주시,50110310,한경면,남성+여성,9031,306,9337,2018년 4월
2018,5,제주시,50110310,한경면,남성+여성,9093,313,9406,2018년 5월
2018,6,제주시,50110310,한경면,남성+여성,9094,343,9437,2018년 6월
2018,7,제주시,50110310,한경면,남성+여성,9087,352,9439,2018년 7월
2018,8,제주시,50110310,한경면,남성+여성,9064,352,9416,2018년 8월
2018,9,제주시,50110310,한경면,남성+여성,9051,365,9416,2018년 9월
2018,10,제주시,50110310,한경면,남성+여성,9074,363,9437,2018년 10월
2018,11,제주시,50110310,한경면,남성+여성,9068,360,9428,2018년 11월
2018,12,제주시,50110310,한경면,남성+여성,9089,358,9447,2018년 12월
2019,1,제주시,50110310,한경면,남성+여성,9086,360,9446,2019년 1월
2019,2,제주시,50110310,한경면,남성+여성,9093,362,9455,2019년 2월
2019,3,제주시,50110310,한경면,남성+여성,9122,362,9484,2019년 3월
2019,4,제주시,50110310,한경면,남성+여성,9134,367,9501,2019년 4월
2019,5,제주시,50110310,한경면,남성+여성,9101,360,9461,2019년 5월
2019,6,제주시,50110310,한경면,남성+여성,9116,360,9476,2019년 6월
2019,7,제주시,50110310,한경면,남성+여성,9118,360,9478,2019년 7월
2019,8,제주시,50110310,한경면,남성+여성,9098,360,9458,2019년 8월
2019,9,제주시,50110310,한경면,남성+여성,9065,358,9423,2019년 9월
2019,10,제주시,50110310,한경면,남성+여성,9072,360,9432,2019년 10월
2019,11,제주시,50110310,한경면,남성+여성,9059,368,9427,2019년 11월
2019,12,제주시,50110310,한경면,남성+여성,9037,368,9405,2019년 12월
2020,1,제주시,50110310,한경면,남성+여성,9044,370,9414,2020년 1월
2020,2,제주시,50110310,한경면,남성+여성,9045,371,9416,2020년 2월
2020,3,제주시,50110310,한경면,남성+여성,9050,359,9409,2020년 3월
2020,4,제주시,50110310,한경면,남성+여성,9021,356,9377,2020년 4월
2020,5,제주시,50110310,한경면,남성+여성,9011,392,9403,2020년 5월
2020,6,제주시,50110310,한경면,남성+여성,9061,406,9467,2020년 6월
2020,7,제주시,50110310,한경면,남성+여성,9079,408,9487,2020년 7월
2020,8,제주시,50110310,한경면,남성+여성,9082,406,9488,2020년 8월
2020,9,제주시,50110310,한경면,남성+여성,9052,405,9457,2020년 9월
2020,10,제주시,50110310,한경면,남성+여성,9049,404,9453,2020년 10월
2020,11,제주시,50110310,한경면,남성+여성,9019,395,9414,2020년 11월
2020,12,제주시,50110310,한경면,남성+여성,9029,393,9422,2020년 12월
2021,1,제주시,50110310,한경면,남성+여성,9041,389,9430,2021년 1월
2021,2,제주시,50110310,한경면,남성+여성,9076,387,9463,2021년 2월
2021,3,제주시,50110310,한경면,남성+여성,9052,384,9436,2021년 3월
2021,4,제주시,50110310,한경면,남성+여성,9097,368,9465,2021년 4월
2021,5,제주시,50110310,한경면,남성+여성,9150,336,9486,2021년 5월
2021,6,제주시,50110310,한경면,남성+여성,9158,337,9495,2021년 6월
2018,1,제주시,50110250,한림읍,남성+여성,20889,3530,24419,2018년 1월
2018,2,제주시,50110250,한림읍,남성+여성,20885,3542,24427,2018년 2월
2018,3,제주시,50110250,한림읍,남성+여성,20996,3536,24532,2018년 3월
2018,4,제주시,50110250,한림읍,남성+여성,21036,3570,24606,2018년 4월
2018,5,제주시,50110250,한림읍,남성+여성,21112,3603,24715,2018년 5월
2018,6,제주시,50110250,한림읍,남성+여성,21101,3667,24768,2018년 6월
2018,7,제주시,50110250,한림읍,남성+여성,21126,3663,24789,2018년 7월
2018,8,제주시,50110250,한림읍,남성+여성,21190,3695,24885,2018년 8월
2018,9,제주시,50110250,한림읍,남성+여성,21197,3716,24913,2018년 9월
2018,10,제주시,50110250,한림읍,남성+여성,21235,3698,24933,2018년 10월
2018,11,제주시,50110250,한림읍,남성+여성,21283,3700,24983,2018년 11월
2018,12,제주시,50110250,한림읍,남성+여성,21309,3694,25003,2018년 12월
2019,1,제주시,50110250,한림읍,남성+여성,21337,3691,25028,2019년 1월
2019,2,제주시,50110250,한림읍,남성+여성,21356,3670,25026,2019년 2월
2019,3,제주시,50110250,한림읍,남성+여성,21376,3649,25025,2019년 3월
2019,4,제주시,50110250,한림읍,남성+여성,21411,3650,25061,2019년 4월
2019,5,제주시,50110250,한림읍,남성+여성,21441,3668,25109,2019년 5월
2019,6,제주시,50110250,한림읍,남성+여성,21442,3675,25117,2019년 6월
2019,7,제주시,50110250,한림읍,남성+여성,21400,3675,25075,2019년 7월
2019,8,제주시,50110250,한림읍,남성+여성,21419,3694,25113,2019년 8월
2019,9,제주시,50110250,한림읍,남성+여성,21388,3696,25084,2019년 9월
2019,10,제주시,50110250,한림읍,남성+여성,21380,3730,25110,2019년 10월
2019,11,제주시,50110250,한림읍,남성+여성,21400,3749,25149,2019년 11월
2019,12,제주시,50110250,한림읍,남성+여성,21365,3715,25080,2019년 12월
2020,1,제주시,50110250,한림읍,남성+여성,21373,3703,25076,2020년 1월
2020,2,제주시,50110250,한림읍,남성+여성,21326,3695,25021,2020년 2월
2020,3,제주시,50110250,한림읍,남성+여성,21280,3662,24942,2020년 3월
2020,4,제주시,50110250,한림읍,남성+여성,21252,3646,24898,2020년 4월
2020,5,제주시,50110250,한림읍,남성+여성,21202,3614,24816,2020년 5월
2020,6,제주시,50110250,한림읍,남성+여성,21198,3604,24802,2020년 6월
2020,7,제주시,50110250,한림읍,남성+여성,21218,3563,24781,2020년 7월
2020,8,제주시,50110250,한림읍,남성+여성,21229,3518,24747,2020년 8월
2020,9,제주시,50110250,한림읍,남성+여성,21225,3486,24711,2020년 9월
2020,10,제주시,50110250,한림읍,남성+여성,21246,3421,24667,2020년 10월
2020,11,제주시,50110250,한림읍,남성+여성,21248,3379,24627,2020년 11월
2020,12,제주시,50110250,한림읍,남성+여성,21249,3360,24609,2020년 12월
2021,1,제주시,50110250,한림읍,남성+여성,21263,3353,24616,2021년 1월
2021,2,제주시,50110250,한림읍,남성+여성,21267,3304,24571,2021년 2월
2021,3,제주시,50110250,한림읍,남성+여성,21214,3280,24494,2021년 3월
2021,4,제주시,50110250,한림읍,남성+여성,21224,3263,24487,2021년 4월
2021,5,제주시,50110250,한림읍,남성+여성,21193,3242,24435,2021년 5월
2021,6,제주시,50110250,한림읍,남성+여성,21232,3230,24462,2021년 6월
2018,1,제주시,50110600,화북동,남성+여성,25155,361,25516,2018년 1월
2018,2,제주시,50110600,화북동,남성+여성,25063,366,25429,2018년 2월
2018,3,제주시,50110600,화북동,남성+여성,25103,363,25466,2018년 3월
2018,4,제주시,50110600,화북동,남성+여성,25069,361,25430,2018년 4월
2018,5,제주시,50110600,화북동,남성+여성,25083,368,25451,2018년 5월
2018,6,제주시,50110600,화북동,남성+여성,25091,374,25465,2018년 6월
2018,7,제주시,50110600,화북동,남성+여성,25073,386,25459,2018년 7월
2018,8,제주시,50110600,화북동,남성+여성,25010,394,25404,2018년 8월
2018,9,제주시,50110600,화북동,남성+여성,25013,397,25410,2018년 9월
2018,10,제주시,50110600,화북동,남성+여성,24965,401,25366,2018년 10월
2018,11,제주시,50110600,화북동,남성+여성,24960,409,25369,2018년 11월
2018,12,제주시,50110600,화북동,남성+여성,24985,406,25391,2018년 12월
2019,1,제주시,50110600,화북동,남성+여성,24943,405,25348,2019년 1월
2019,2,제주시,50110600,화북동,남성+여성,24906,409,25315,2019년 2월
2019,3,제주시,50110600,화북동,남성+여성,24918,422,25340,2019년 3월
2019,4,제주시,50110600,화북동,남성+여성,24885,425,25310,2019년 4월
2019,5,제주시,50110600,화북동,남성+여성,24942,426,25368,2019년 5월
2019,6,제주시,50110600,화북동,남성+여성,24947,422,25369,2019년 6월
2019,7,제주시,50110600,화북동,남성+여성,24959,420,25379,2019년 7월
2019,8,제주시,50110600,화북동,남성+여성,24906,415,25321,2019년 8월
2019,9,제주시,50110600,화북동,남성+여성,24872,421,25293,2019년 9월
2019,10,제주시,50110600,화북동,남성+여성,24870,433,25303,2019년 10월
2019,11,제주시,50110600,화북동,남성+여성,24894,429,25323,2019년 11월
2019,12,제주시,50110600,화북동,남성+여성,24855,416,25271,2019년 12월
2020,1,제주시,50110600,화북동,남성+여성,24850,418,25268,2020년 1월
2020,2,제주시,50110600,화북동,남성+여성,24801,412,25213,2020년 2월
2020,3,제주시,50110600,화북동,남성+여성,24743,399,25142,2020년 3월
2020,4,제주시,50110600,화북동,남성+여성,24756,397,25153,2020년 4월
2020,5,제주시,50110600,화북동,남성+여성,24709,392,25101,2020년 5월
2020,6,제주시,50110600,화북동,남성+여성,24670,394,25064,2020년 6월
2020,7,제주시,50110600,화북동,남성+여성,24677,392,25069,2020년 7월
2020,8,제주시,50110600,화북동,남성+여성,24635,389,25024,2020년 8월
2020,9,제주시,50110600,화북동,남성+여성,24580,389,24969,2020년 9월
2020,10,제주시,50110600,화북동,남성+여성,24546,376,24922,2020년 10월
2020,11,제주시,50110600,화북동,남성+여성,24501,369,24870,2020년 11월
2020,12,제주시,50110600,화북동,남성+여성,24456,363,24819,2020년 12월
2021,1,제주시,50110600,화북동,남성+여성,24435,364,24799,2021년 1월
2021,2,제주시,50110600,화북동,남성+여성,24434,357,24791,2021년 2월
2021,3,제주시,50110600,화북동,남성+여성,24422,343,24765,2021년 3월
2021,4,제주시,50110600,화북동,남성+여성,24380,336,24716,2021년 4월
2021,5,제주시,50110600,화북동,남성+여성,24303,336,24639,2021년 5월
2021,6,제주시,50110600,화북동,남성+여성,24300,330,24630,2021년 6월
2018,1,서귀포시,50130550,효돈동,남성+여성,5325,82,5407,2018년 1월
2018,2,서귀포시,50130550,효돈동,남성+여성,5319,82,5401,2018년 2월
2018,3,서귀포시,50130550,효돈동,남성+여성,5318,81,5399,2018년 3월
2018,4,서귀포시,50130550,효돈동,남성+여성,5312,82,5394,2018년 4월
2018,5,서귀포시,50130550,효돈동,남성+여성,5319,83,5402,2018년 5월
2018,6,서귀포시,50130550,효돈동,남성+여성,5322,81,5403,2018년 6월
2018,7,서귀포시,50130550,효돈동,남성+여성,5334,83,5417,2018년 7월
2018,8,서귀포시,50130550,효돈동,남성+여성,5340,84,5424,2018년 8월
2018,9,서귀포시,50130550,효돈동,남성+여성,5335,82,5417,2018년 9월
2018,10,서귀포시,50130550,효돈동,남성+여성,5302,84,5386,2018년 10월
2018,11,서귀포시,50130550,효돈동,남성+여성,5289,83,5372,2018년 11월
2018,12,서귀포시,50130550,효돈동,남성+여성,5278,87,5365,2018년 12월
2019,1,서귀포시,50130550,효돈동,남성+여성,5279,86,5365,2019년 1월
2019,2,서귀포시,50130550,효돈동,남성+여성,5292,85,5377,2019년 2월
2019,3,서귀포시,50130550,효돈동,남성+여성,5306,84,5390,2019년 3월
2019,4,서귀포시,50130550,효돈동,남성+여성,5292,78,5370,2019년 4월
2019,5,서귀포시,50130550,효돈동,남성+여성,5285,82,5367,2019년 5월
2019,6,서귀포시,50130550,효돈동,남성+여성,5287,83,5370,2019년 6월
2019,7,서귀포시,50130550,효돈동,남성+여성,5294,79,5373,2019년 7월
2019,8,서귀포시,50130550,효돈동,남성+여성,5301,81,5382,2019년 8월
2019,9,서귀포시,50130550,효돈동,남성+여성,5301,79,5380,2019년 9월
2019,10,서귀포시,50130550,효돈동,남성+여성,5303,83,5386,2019년 10월
2019,11,서귀포시,50130550,효돈동,남성+여성,5297,80,5377,2019년 11월
2019,12,서귀포시,50130550,효돈동,남성+여성,5291,75,5366,2019년 12월
2020,1,서귀포시,50130550,효돈동,남성+여성,5284,75,5359,2020년 1월
2020,2,서귀포시,50130550,효돈동,남성+여성,5270,74,5344,2020년 2월
2020,3,서귀포시,50130550,효돈동,남성+여성,5287,74,5361,2020년 3월
2020,4,서귀포시,50130550,효돈동,남성+여성,5272,74,5346,2020년 4월
2020,5,서귀포시,50130550,효돈동,남성+여성,5254,71,5325,2020년 5월
2020,6,서귀포시,50130550,효돈동,남성+여성,5255,73,5328,2020년 6월
2020,7,서귀포시,50130550,효돈동,남성+여성,5263,72,5335,2020년 7월
2020,8,서귀포시,50130550,효돈동,남성+여성,5254,74,5328,2020년 8월
2020,9,서귀포시,50130550,효돈동,남성+여성,5252,73,5325,2020년 9월
2020,10,서귀포시,50130550,효돈동,남성+여성,5245,73,5318,2020년 10월
2020,11,서귀포시,50130550,효돈동,남성+여성,5235,73,5308,2020년 11월
2020,12,서귀포시,50130550,효돈동,남성+여성,5253,71,5324,2020년 12월
2021,1,서귀포시,50130550,효돈동,남성+여성,5272,67,5339,2021년 1월
2021,2,서귀포시,50130550,효돈동,남성+여성,5289,65,5354,2021년 2월
2021,3,서귀포시,50130550,효돈동,남성+여성,5262,61,5323,2021년 3월
2021,4,서귀포시,50130550,효돈동,남성+여성,5267,59,5326,2021년 4월
2021,5,서귀포시,50130550,효돈동,남성+여성,5266,60,5326,2021년 5월
2021,6,서귀포시,50130550,효돈동,남성+여성,5257,57,5314,2021년 6월
